id,title,imdbID,spanishTitle,imdbPictureURL,year,rtID,rtAllCriticsRating,rtAllCriticsNumReviews,rtAllCriticsNumFresh,rtAllCriticsNumRotten,rtAllCriticsScore,rtTopCriticsRating,rtTopCriticsNumReviews,rtTopCriticsNumFresh,rtTopCriticsNumRotten,rtTopCriticsScore,rtAudienceRating,rtAudienceNumRatings,rtAudienceScore,rtPictureURL,difference
36533,Cry_Wolf,384286,Cry_Wolf,"http://ia.media-imdb.com/images/M/MV5BODA0ODMyNDA2N15BMl5BanBnXkFtZTcwNDAxMDAzMQ@@._V1._SX214_CR0,0,214,314_.jpg",2005,cry-wolf,4,43,10,33,23,4.6,10,4,6,40,3,9727,57,http://content6.flixster.com/movie/10/89/13/10891348_det.jpg,-34
26413,Se ying diu sau,78252,La serpiente a la sombra del águila,"http://ia.media-imdb.com/images/M/MV5BMjEyMTUwOTIxNF5BMl5BanBnXkFtZTcwNTIwNjYyMQ@@._V1._SY314_CR2,0,214,314_.jpg",1978,snake_in_the_eagles_shadow,0,2,1,1,50,0,0,0,0,0,0,0,0,http://content6.flixster.com/movie/26/56/265628_det.jpg,50
8710,Map of the Human Heart,104812,El mapa del sentimiento humano,"http://ia.media-imdb.com/images/M/MV5BMTIwNDMwNzEyM15BMl5BanBnXkFtZTcwMzI5OTUyMQ@@._V1._SY314_CR3,0,214,314_.jpg",1993,map_of_the_human_heart,6.8,20,16,4,80,0,4,3,1,75,3.7,666,74,http://content8.flixster.com/movie/10/90/03/10900366_det.jpg,6
7197,Ransom,117438,Rescate (Ransom),"http://ia.media-imdb.com/images/M/MV5BMjEzMzE2NjY0NF5BMl5BanBnXkFtZTcwMzU2MDUyMQ@@._V1._SY314_CR4,0,214,314_.jpg",1996,1074298-ransom,6.4,30,21,9,70,5.7,7,4,3,57,3.1,10364,61,http://content9.flixster.com/movie/10/91/77/10917783_det.jpg,9
4427,The Lion in Winter,63227,El león en invierno,"http://ia.media-imdb.com/images/M/MV5BNTg0MzMzMTYwMV5BMl5BanBnXkFtZTYwMzkwOTg4._V1._SY314_CR0,0,214,314_.jpg",1968,1012386-lion_in_winter,8,21,20,1,95,0,4,4,0,100,4.1,3596,88,http://content7.flixster.com/movie/11/14/62/11146205_det.jpg,7
4146,The Million Dollar Hotel,120753,El hotel del millón de dólares,"http://ia.media-imdb.com/images/M/MV5BMzA5NTIwNzUxM15BMl5BanBnXkFtZTcwMTUyNjYyMQ@@._V1._SY314_CR10,0,214,314_.jpg",2000,million_dollar_hotel,4.2,41,10,31,24,3.5,13,2,11,15,3.4,3687,64,http://content7.flixster.com/movie/65/00/650017_det.jpg,-40
34608,The Best of Everything,52619,Mujeres frente al amor,"http://ia.media-imdb.com/images/M/MV5BMzU5MjY2MDgyNl5BMl5BanBnXkFtZTcwNTkwMjkyMQ@@._V1._SY314_CR2,0,214,314_.jpg",1959,best_of_everything,0,4,2,2,50,0,0,0,0,0,0,0,0,http://content9.flixster.com/movie/35/53/85/3553851_det.jpg,50
4109,Flowers in the Attic,93036,Flores en el ático,"http://ia.media-imdb.com/images/M/MV5BMTIzMzgwNDczMl5BMl5BanBnXkFtZTcwNTg3MDQyMQ@@._V1._SY314_CR2,0,214,314_.jpg",1987,flowers_in_the_attic,3.4,7,1,6,14,0,0,0,0,0,0,0,0,http://content8.flixster.com/movie/10/87/05/10870534_det.jpg,14
61354,College,844671,College,"http://ia.media-imdb.com/images/M/MV5BMTc4Mjc1NzIxOF5BMl5BanBnXkFtZTcwMjEzMjc3MQ@@._V1._SX214_CR0,0,214,314_.jpg",2008,1191620-college,2.5,40,2,38,5,2.8,12,1,11,8,2.8,10667,35,http://content9.flixster.com/movie/10/84/13/10841311_det.jpg,-30
54648,Rush Hour 3,293564,Hora Punta 3,"http://ia.media-imdb.com/images/M/MV5BMTA0Nzg5NjQ0MDBeQTJeQWpwZ15BbWU3MDE4Mzg5NDE@._V1._SX214_CR0,0,214,314_.jpg",2007,rush_hour_3,4.2,155,30,125,19,4.4,29,6,23,20,3.5,270729,68,http://content9.flixster.com/movie/94/51/35/9451359_det.jpg,-49
7414,Going in Style,79219,Going in Style,"http://ia.media-imdb.com/images/M/MV5BMTk1ODQ5ODk4Ml5BMl5BanBnXkFtZTcwMDU0MDUyMQ@@._V1._SY314_CR22,0,214,314_.jpg",1979,going_in_style,0,4,4,0,100,0,0,0,0,0,0,0,0,http://content7.flixster.com/movie/26/52/265293_det.jpg,100
3876,Tom and Jerry: The Movie,105616,Tom y Jerry: la película,"http://ia.media-imdb.com/images/M/MV5BMTk3OTA0NDMzM15BMl5BanBnXkFtZTcwOTMwMTAyMQ@@._V1._SX214_CR0,0,214,314_.jpg",1992,tom_and_jerry_the_movie,2.8,6,1,5,16,0,0,0,0,0,0,0,0,http://content6.flixster.com/movie/25/23/252328_det.jpg,16
5869,True Confessions,83232,Confesiones verdaderas,"http://ia.media-imdb.com/images/M/MV5BMTU2NjM0NjgwN15BMl5BanBnXkFtZTcwMDQ2NjU0MQ@@._V1._SY314_CR7,0,214,314_.jpg",1981,true_confessions,7.5,6,6,0,100,0,1,1,0,100,3.3,674,55,http://content6.flixster.com/movie/36/46/41/3646416_det.jpg,45
3415,Zerkalo,72443,El espejo,"http://ia.media-imdb.com/images/M/MV5BMTUzNTM3Nzg1NF5BMl5BanBnXkFtZTcwMDk1MDIyMQ@@._V1._SX214_CR0,0,214,314_.jpg",1975,1036046-mirror,9.2,6,6,0,100,0,1,1,0,100,4.4,2940,93,http://content9.flixster.com/movie/10/87/92/10879271_det.jpg,7
26746,Out for Justice,102614,Buscando justicia,"http://ia.media-imdb.com/images/M/MV5BMzY3NTE3NzI4NV5BMl5BanBnXkFtZTcwMDEyOTIyMQ@@._V1._SX214_CR0,0,214,314_.jpg",1991,out_for_justice,3.6,20,4,16,20,0,4,1,3,25,3,3054,57,http://content8.flixster.com/movie/27/30/273022_det.jpg,-37
4165,Eu Tu Eles,244504,Eu Tu Eles,"http://ia.media-imdb.com/images/M/MV5BMTU5MDI3OTEyMV5BMl5BanBnXkFtZTYwNTMzNTg5._V1._SX214_CR0,0,214,314_.jpg",2000,me_you_them,6.4,55,41,14,74,6.5,19,14,5,73,3.4,377,62,http://content8.flixster.com/movie/10/91/34/10913466_det.jpg,12
6847,There Goes My Baby,108320,There Goes My Baby: ahí va mi chica,"http://ia.media-imdb.com/images/M/MV5BMTgzODU0OTAwMl5BMl5BanBnXkFtZTcwMTE4ODkxMQ@@._V1._SY314_CR2,0,214,314_.jpg",1994,there_goes_my_baby,0,1,0,1,0,0,0,0,0,0,0,0,0,http://content7.flixster.com/movie/10/91/77/10917793_det.jpg,0
4226,Memento,209144,Memento,"http://ia.media-imdb.com/images/M/MV5BMjI1MTAzMDczNl5BMl5BanBnXkFtZTcwNDM1NDE3Mw@@._V1._SX214_CR0,0,214,314_.jpg",2000,memento,8.1,135,125,10,92,7.7,32,30,2,93,4,103567,93,http://content9.flixster.com/movie/26/78/267827_det.jpg,-1
7364,Intermission,332658,Intermission,"http://ia.media-imdb.com/images/M/MV5BMjE2OTA2MzAyOV5BMl5BanBnXkFtZTcwMzIzMTYyMQ@@._V1._SY228_CR44,0,214,228_.jpg",2003,intermission,6.6,96,70,26,72,6.8,28,21,7,75,3.6,2948,76,http://content7.flixster.com/movie/10/37/24/10372401_det.jpg,-4
27768,Confidences trop intimes,363532,Confidencias muy íntimas,"http://ia.media-imdb.com/images/M/MV5BMTI1MzczNDM1NV5BMl5BanBnXkFtZTcwMTUyMzYyMQ@@._V1._SX214_CR0,0,214,314_.jpg",2004,1132500-intimate_strangers,7.3,100,87,13,87,7.2,32,27,5,84,3.4,696,65,http://content6.flixster.com/movie/95/02/25/9502252_det.jpg,22
1702,Flubber,119137,Flubber y el profesor chiflado,"http://ia.media-imdb.com/images/M/MV5BMTUyMTQxMjg2MF5BMl5BanBnXkFtZTcwODUxMTYyMQ@@._V1._SY313_CR1,0,214,313_.jpg",1997,flubber,3.7,29,5,24,17,4.3,6,1,5,16,2.8,23244,43,http://content7.flixster.com/movie/10/90/92/10909265_det.jpg,-26
3542,Coming Apart,64180,Coming Apart,"http://ia.media-imdb.com/images/M/MV5BMTUyNzg1MDc3OF5BMl5BanBnXkFtZTcwODEzOTEyMQ@@._V1._SY314_CR2,0,214,314_.jpg",1969,coming_apart,0,4,2,2,50,0,0,0,0,0,0,0,0,http://content8.flixster.com/movie/10/84/83/10848318_det.jpg,50
47261,The Night Listener,448075,Voces en la noche,"http://ia.media-imdb.com/images/M/MV5BMTI0MzM0NjkzMF5BMl5BanBnXkFtZTcwMDA0MTkzMQ@@._V1._SY314_CR5,0,214,314_.jpg",2006,the_night_listener,5.4,133,53,80,39,5.2,29,9,20,31,2.9,28560,36,http://content7.flixster.com/movie/18/57/11/1857117_det.jpg,3
382,Wolf,111742,Lobo,"http://ia.media-imdb.com/images/M/MV5BMTc3NjY2NDc3Ml5BMl5BanBnXkFtZTYwMDk4OTA5._V1._SX214_CR0,0,214,314_.jpg",1994,1053942-wolf,5.9,48,29,19,60,5.9,8,5,3,62,2.8,6634,43,http://content7.flixster.com/movie/10/26/03/10260341_det.jpg,17
32300,D.E.B.S.,367631,D.E.B.S. - espías en acción,"http://ia.media-imdb.com/images/M/MV5BMjA0OTU5ODgyOF5BMl5BanBnXkFtZTcwODczNDgyMQ@@._V1._SX214_CR0,0,214,314_.jpg",2004,debs,4.7,58,23,35,39,4.7,21,8,13,38,2.9,4690,52,http://content7.flixster.com/movie/60/49/01/6049013_det.jpg,-13
6775,Life and Debt,284262,Life and Debt,"http://ia.media-imdb.com/images/M/MV5BMTA5MjQ2NjIyMTFeQTJeQWpwZ15BbWU3MDUwNjEzMjE@._V1._SY314_CR2,0,214,314_.jpg",2001,life_and_debt,7.3,42,38,4,90,7.6,12,12,0,100,4.1,552,90,http://content6.flixster.com/movie/11/14/65/11146556_det.jpg,0
429,Cabin Boy,109361,Cabin Boy,"http://ia.media-imdb.com/images/M/MV5BMTIwMjk3OTczNF5BMl5BanBnXkFtZTYwNjM4Mjg5._V1._SX214_CR0,0,214,314_.jpg",1994,cabin_boy,4.9,23,10,13,43,0,2,0,2,0,2.4,1694,36,http://content8.flixster.com/movie/26/13/261398_det.jpg,7
46322,Huo Yuan Jia,446059,Fearless - Sin miedo,"http://ia.media-imdb.com/images/M/MV5BMTI5MjA2Mzk2M15BMl5BanBnXkFtZTcwODY1MDUzMQ@@._V1._SX214_CR0,0,214,314_.jpg",2006,fearless-a-chinese-hero,0,0,0,0,0,0,0,0,0,0,0,0,0,http://content9.flixster.com/movie/10/85/48/10854871_det.jpg,0
2806,Teaching Mrs. Tingle,133046,Secuestrando a la Srta. Tingle,"http://ia.media-imdb.com/images/M/MV5BMTgyNDI3NTAzOV5BMl5BanBnXkFtZTcwOTc3NTEzMQ@@._V1._SY314_CR8,0,214,314_.jpg",1999,teaching_mrs_tingle,4,68,13,55,19,4,24,5,19,20,2.5,4339,34,http://content8.flixster.com/movie/26/66/266698_det.jpg,-15
1026,So Dear to My Heart,41890,So Dear to My Heart,"http://ia.media-imdb.com/images/M/MV5BMTI1NTAyNDg5NF5BMl5BanBnXkFtZTcwNTc2ODcxMQ@@._V1._SY314_CR8,0,214,314_.jpg",1948,so_dear_to_my_heart,0,0,0,0,0,0,0,0,0,0,0,0,0,http://content8.flixster.com/movie/56/75/49/5675490_det.jpg,0
4179,Pixote: A Lei do Mais Fraco,82912,"Pixote, la ley del más débil","http://ia.media-imdb.com/images/M/MV5BMTYxMzcyNTM1M15BMl5BanBnXkFtZTcwODg2NzMyMQ@@._V1._SY314_CR3,0,214,314_.jpg",1981,pixote,8.6,9,9,0,100,0,0,0,0,0,0,0,0,http://content9.flixster.com/movie/28/08/280891_det.jpg,100
5516,Sur mes lèvres,274117,Lee mis labios,"http://ia.media-imdb.com/images/M/MV5BMjExNzg4MDA5MF5BMl5BanBnXkFtZTYwNjMxMzg5._V1._SY309_CR1,0,214,309_.jpg",2001,read_my_lips,7.8,95,92,3,96,8.1,26,25,1,96,3.8,1495,81,http://content8.flixster.com/movie/10/88/74/10887498_det.jpg,15
1367,One Hundred and One Dalmatians,55254,101 dálmatas,"http://ia.media-imdb.com/images/M/MV5BMTI2OTA5NjU0N15BMl5BanBnXkFtZTcwODc3MDYyMQ@@._V1._SY288_CR1,0,214,288_.jpg",1961,1036674-101_dalmatians,8,37,36,1,97,7.6,5,5,0,100,3.3,29711,63,http://content7.flixster.com/movie/10/92/06/10920681_det.jpg,34
2236,Simon Birch,124879,El inolvidable Simon Birch,"http://ia.media-imdb.com/images/M/MV5BMTIzMDMzODIxMF5BMl5BanBnXkFtZTcwMTgxNjUyMQ@@._V1._SY314_CR5,0,214,314_.jpg",1998,simon_birch,5.8,32,14,18,43,5.4,6,2,4,33,3.4,8747,76,http://content7.flixster.com/movie/25/50/255097_det.jpg,-33
4091,Can't Buy Me Love,92718,No puedes comprar mi amor,"http://ia.media-imdb.com/images/M/MV5BMTUxMzIyMzIyMV5BMl5BanBnXkFtZTcwNDcyNjUyMQ@@._V1._SX214_CR0,0,214,314_.jpg",1987,cant_buy_me_love,4.8,19,8,11,42,0,3,0,3,0,3.3,7122,73,http://content9.flixster.com/movie/25/49/254907_det.jpg,-31
5316,Enigma,157583,Enigma,"http://ia.media-imdb.com/images/M/MV5BMjAyMTg3Nzc3N15BMl5BanBnXkFtZTcwOTU3MDMyMQ@@._V1._SY314_CR1,0,214,314_.jpg",2001,1113649-enigma,6.6,104,75,29,72,6.8,29,22,7,75,3.2,2061,52,http://content6.flixster.com/movie/27/95/279508_det.jpg,20
49647,Charlotte's Web,413895,La telaraña de Carlota,"http://ia.media-imdb.com/images/M/MV5BMTQ5MTUzMTAzMl5BMl5BanBnXkFtZTcwNTE0NTcyMw@@._V1._SX214_CR0,0,214,314_.jpg",2006,charlottes_web,7,142,111,31,78,6.9,35,25,10,71,3.3,39179,67,http://content9.flixster.com/movie/31/82/33/3182335_det.jpg,11
4717,The Big Brawl,80436,La furia de Chicago,"http://ia.media-imdb.com/images/M/MV5BMjA4ODg5ODY3M15BMl5BanBnXkFtZTcwNTUzMjYyMQ@@._V1._SY314_CR2,0,214,314_.jpg",1980,1002306-big_brawl,5.1,6,4,2,66,0,0,0,0,0,0,0,0,http://content6.flixster.com/movie/10/86/99/10869972_det.jpg,66
5273,Very Annie Mary,188128,Very Annie Mary,"http://ia.media-imdb.com/images/M/MV5BMjA4NzEyNDc2NV5BMl5BanBnXkFtZTcwNDIxMDUyMQ@@._V1._SY314_CR4,0,214,314_.jpg",2001,very_annie_mary,4.9,27,8,19,29,4.8,9,2,7,22,3.8,488,75,http://content7.flixster.com/movie/10/88/94/10889493_det.jpg,-46
35015,Duma,361715,Duma,"http://ia.media-imdb.com/images/M/MV5BMTY5NDgxOTYwMl5BMl5BanBnXkFtZTcwMzIzNTA0MQ@@._V1._SY314_CR32,0,214,314_.jpg",2005,duma,7.5,59,55,4,93,7.4,25,23,2,92,3.3,11201,57,http://content6.flixster.com/movie/25/02/250224_det.jpg,36
5528,One Hour Photo,265459,Retratos de una obsesión,"http://ia.media-imdb.com/images/M/MV5BMTg5MTc0MjExMF5BMl5BanBnXkFtZTYwODg5NTU5._V1._SX214_CR0,0,214,314_.jpg",2002,family-flaw,0,0,0,0,0,0,0,0,0,0,0,0,0,http://content9.flixster.com/movie/10/85/41/10854183_det.jpg,0
4033,Thirteen Days,146309,Trece días,"http://ia.media-imdb.com/images/M/MV5BMTMzOTUxODAzMV5BMl5BanBnXkFtZTcwODg0MDAzMQ@@._V1._SY314_CR7,0,214,314_.jpg",2000,thirteen_days,7.1,114,94,20,82,7.1,28,24,4,85,3.4,4777,76,http://content9.flixster.com/movie/10/89/34/10893483_det.jpg,6
3704,Mad Max Beyond Thunderdome,89530,"Mad Max, más allá de la cúpula del trueno","http://ia.media-imdb.com/images/M/MV5BMTk0MDQ5NTYxNV5BMl5BanBnXkFtZTcwNTA0ODYyMQ@@._V1._SY314_CR10,0,214,314_.jpg",1985,mad_max_beyond_thunderdome,6.3,37,30,7,81,6.7,7,6,1,85,3.1,11185,50,http://content7.flixster.com/movie/10/88/83/10888321_det.jpg,31
4481,The Boost,94783,Impulso sensual,"http://ia.media-imdb.com/images/M/MV5BMTYyNDIyNjI4NV5BMl5BanBnXkFtZTcwNDE0NjUyMQ@@._V1._SY314_CR4,0,214,314_.jpg",1988,boost,5.1,6,3,3,50,0,1,1,0,100,3.2,281,52,http://content8.flixster.com/movie/27/61/276122_det.jpg,-2
6765,Under the Tuscan Sun,328589,Bajo el sol de la Toscana,"http://ia.media-imdb.com/images/M/MV5BMTgwMjEwNzMzNV5BMl5BanBnXkFtZTcwNDU4MTYyMQ@@._V1._SX214_CR0,0,214,314_.jpg",2003,under_the_tuscan_sun,6.2,143,87,56,60,6.3,35,21,14,60,3.4,14219,77,http://content9.flixster.com/movie/25/50/255095_det.jpg,-17
5988,Quicksilver,91814,Quicksilver,"http://ia.media-imdb.com/images/M/MV5BMTIwNDgzOTk1OF5BMl5BanBnXkFtZTcwMzg4NjQyMQ@@._V1._SY314_CR0,0,214,314_.jpg",1986,quicksilver,3.1,12,1,11,8,0,1,0,1,0,2.8,823,34,http://content7.flixster.com/movie/25/96/259605_det.jpg,-26
6781,"Jakob, der Lügner",71688,"Jakob, der Lügner","http://ia.media-imdb.com/images/M/MV5BMjEyNzkxNDE5M15BMl5BanBnXkFtZTcwNDc1MDMyMQ@@._V1._SY314_CR3,0,214,314_.jpg",1975,jacob_the_liar,6.3,5,5,0,100,0,0,0,0,0,0,0,0,http://content9.flixster.com/movie/10/53/56/10535615_det.jpg,100
26606,Sien nui yau wan,93978,Una historia china de fantasmas,http://ia.media-imdb.com/images/M/MV5BMTg4MTgxNDEzMF5BMl5BanBnXkFtZTcwNjQ0MjQyMQ@@._V1._SX99_SY140_.jpg,1987,chinese_ghost_story,7.8,8,6,2,75,0,0,0,0,0,0,0,0,http://content7.flixster.com/movie/11/12/73/11127361_det.jpg,75
4493,Critters 2,94919,Critters 2,"http://ia.media-imdb.com/images/M/MV5BMjAwMDUxNjMwMV5BMl5BanBnXkFtZTcwNTMwMTYyMQ@@._V1._SX214_CR0,0,214,314_.jpg",1988,critters_2_the_main_course,4.4,9,3,6,33,0,1,0,1,0,2.6,2866,38,http://content8.flixster.com/movie/26/18/261894_det.jpg,-5
2490,Payback,120784,Payback,"http://ia.media-imdb.com/images/M/MV5BMjAwMTI0Mjk5NV5BMl5BanBnXkFtZTYwMTczNzc5._V1._SY314_CR7,0,214,314_.jpg",1999,1087648-payback,5.8,70,36,34,51,5,19,8,11,42,3.2,12940,67,http://content8.flixster.com/movie/26/99/269918_det.jpg,-16
34155,Saraband,299478,Saraband,"http://ia.media-imdb.com/images/M/MV5BMTI1MTgwNzcwOF5BMl5BanBnXkFtZTcwNjExNDAzMQ@@._V1._SX214_CR0,0,214,314_.jpg",2003,saraband,7.9,78,73,5,93,8.2,26,24,2,92,3.9,1427,83,http://content8.flixster.com/movie/21/01/14/2101146_det.jpg,10
3492,The Son of the Sheik,17416,El hijo del caíd,http://ia.media-imdb.com/images/M/MV5BMTQ4OTEwNzYwMV5BMl5BanBnXkFtZTcwODcyODcxMQ@@._V1._SX97_SY140_.jpg,1926,son_of_the_sheik,6.8,6,4,2,66,0,0,0,0,0,0,0,0,http://content6.flixster.com/movie/10/92/69/10926908_det.jpg,66
7247,Chitty Chitty Bang Bang,62803,Chitty Chitty Bang Bang,"http://ia.media-imdb.com/images/M/MV5BMTcwODk5NjM2M15BMl5BanBnXkFtZTcwMTg1MDU1MQ@@._V1._SY314_CR8,0,214,314_.jpg",1968,chitty_chitty_bang_bang,5.4,22,13,9,59,0,2,2,0,100,3.2,18830,65,http://content6.flixster.com/movie/25/07/250720_det.jpg,-6
6135,Still of the Night,84732,Bajo sospecha,"http://ia.media-imdb.com/images/M/MV5BMTA2MTcyMjU4NzFeQTJeQWpwZ15BbWU2MDU1NDA5OQ@@._V1._SX214_CR0,0,214,314_.jpg",1982,still_of_the_night,5.8,6,4,2,66,0,0,0,0,0,0,0,0,http://content7.flixster.com/movie/68/63/51/6863517_det.jpg,66
8679,The Deer Hunter,77416,El cazador,"http://ia.media-imdb.com/images/M/MV5BMTY2MzI3ODU3Nl5BMl5BanBnXkFtZTcwMjkzMzMzMQ@@._V1._SY314_CR2,0,214,314_.jpg",1978,deer_hunter,8.3,44,40,4,90,7.1,5,4,1,80,4.1,27513,91,http://content6.flixster.com/movie/26/75/267592_det.jpg,-1
7179,Wuthering Heights,32145,Cumbres borrascosas,"http://ia.media-imdb.com/images/M/MV5BMTYyNDY3ODI1N15BMl5BanBnXkFtZTcwNjg3MDcyMQ@@._V1._SY314_CR5,0,214,314_.jpg",1939,1024192-wuthering_heights,7.9,16,16,0,100,0,1,1,0,100,3.9,2525,84,http://content7.flixster.com/movie/31/37/313797_det.jpg,16
8672,Battle Hymn,50171,Himno de batalla,"http://ia.media-imdb.com/images/M/MV5BMTIwMjIzNTYzMl5BMl5BanBnXkFtZTcwOTIxMTUyMQ@@._V1._SY314_CR3,0,214,314_.jpg",1957,battle_hymn,0,4,1,3,25,0,1,0,1,0,2.9,249,30,http://content7.flixster.com/movie/30/25/302525_det.jpg,-5
2253,Toys,105629,Toys,"http://ia.media-imdb.com/images/M/MV5BMTg2NDE0NTA0MV5BMl5BanBnXkFtZTcwODg5MjcxMQ@@._V1._SY314_CR4,0,214,314_.jpg",1992,toys,4.1,22,6,16,27,0,3,0,3,0,2.6,6312,39,http://content9.flixster.com/movie/10/87/80/10878095_det.jpg,-12
52717,The Condemned,443473,The Condemned,"http://ia.media-imdb.com/images/M/MV5BNzkyOTczMjU0M15BMl5BanBnXkFtZTcwMDExMzM0MQ@@._V1._SX214_CR0,0,214,314_.jpg",2007,condemned,3.5,99,15,84,15,3.3,28,3,25,10,3.4,27981,63,http://content9.flixster.com/movie/52/53/61/5253611_det.jpg,-48
4394,Beach Blanket Bingo,58953,Beach Blanket Bingo,"http://ia.media-imdb.com/images/M/MV5BMjA0MzE3ODA5NV5BMl5BanBnXkFtZTcwOTIwMjUxMQ@@._V1._SX214_CR0,0,214,314_.jpg",1965,beach_blanket_bingo,5.4,7,5,2,71,0,0,0,0,0,0,0,0,http://content8.flixster.com/movie/28/81/288114_det.jpg,71
4157,The Price of Milk,249893,El precio de la leche,"http://ia.media-imdb.com/images/M/MV5BMTU2NzY1MzAwM15BMl5BanBnXkFtZTcwMzMzMzAzMQ@@._V1._SY314_CR3,0,214,314_.jpg",2000,price_of_milk,5.4,47,23,24,48,5.5,16,8,8,50,3.7,727,69,http://content6.flixster.com/movie/10/87/85/10878580_det.jpg,-21
4476,Big Business,19688,Big Business,"http://ia.media-imdb.com/images/M/MV5BMTQyMzU1MzQ4OV5BMl5BanBnXkFtZTcwNjUyNjMyMQ@@._V1._SX214_CR0,0,214,314_.jpg",1929,big_business-1929,0,2,2,0,100,0,0,0,0,0,0,0,0,http://content9.flixster.com/movie/10/97/91/10979167_det.jpg,100
915,Sabrina,47437,Sabrina,"http://ia.media-imdb.com/images/M/MV5BMTYyNDM1NTQ5Nl5BMl5BanBnXkFtZTcwMTA5NjEwMg@@._V1._SY314_CR50,0,214,314_.jpg",1954,1018047-sabrina,7.4,31,28,3,90,7.2,5,5,0,100,3.8,12812,87,http://content7.flixster.com/movie/10/93/36/10933669_det.jpg,3
3146,Deuce Bigalow: Male Gigolo,205000,Gigoló,"http://ia.media-imdb.com/images/M/MV5BNjg4OTE5ODAzM15BMl5BanBnXkFtZTcwODY4NTMzMQ@@._V1._SY314_CR4,0,214,314_.jpg",1999,deuce_bigalow_male_gigolo,4,73,17,56,23,3.2,18,1,17,5,2.9,18036,55,http://content6.flixster.com/movie/27/05/270504_det.jpg,-32
2178,Frenzy,68611,Frenesí,"http://ia.media-imdb.com/images/M/MV5BMTg5MDAyOTM1OF5BMl5BanBnXkFtZTcwMDM3MTMyMQ@@._V1._SX214_CR0,0,214,314_.jpg",1972,frenzy,7.4,30,26,4,86,0,2,2,0,100,3.6,3790,74,http://content6.flixster.com/movie/27/01/270104_det.jpg,12
1021,Angels in the Outfield,43286,Angels in the Outfield,"http://ia.media-imdb.com/images/M/MV5BODcwOTY3MzMxMl5BMl5BanBnXkFtZTcwMjE0MjMzMQ@@._V1._SY314_CR94,0,214,314_.jpg",1951,1048301-angels_in_the_outfield,0,1,1,0,100,0,0,0,0,0,0,0,0,http://content8.flixster.com/movie/10/89/81/10898186_det.jpg,100
3693,The Toxic Avenger,90190,El vengador tóxico,"http://ia.media-imdb.com/images/M/MV5BMjA3MDUzMTU1M15BMl5BanBnXkFtZTcwODMxMzgyMQ@@._V1._SY314_CR0,0,214,314_.jpg",1984,toxic_avenger,5.4,16,10,6,62,0,3,3,0,100,3.1,5107,60,http://content8.flixster.com/movie/10/93/48/10934830_det.jpg,2
6006,Just Married,305711,Recién casados,"http://ia.media-imdb.com/images/M/MV5BMTk1MzM4NzUzNl5BMl5BanBnXkFtZTcwMDQyMDczMw@@._V1._SX214_CR0,0,214,314_.jpg",2003,just-married-marriage-was-only-the-beginning,0,0,0,0,0,0,0,0,0,0,0,0,0,http://content6.flixster.com/movie/11/14/71/11147160_det.jpg,0
1951,Oliver!,63385,Oliver,http://ia.media-imdb.com/images/M/MV5BMTczNzIyMTU4Ml5BMl5BanBnXkFtZTYwMDAzMjg5._V1._SX150_SY211_.jpg,1968,oliver,7.7,25,21,4,84,0,4,3,1,75,3.4,9490,72,http://content9.flixster.com/movie/11/15/34/11153479_det.jpg,12
477,What's Love Got to Do with It,108551,Tina,"http://ia.media-imdb.com/images/M/MV5BMTU2ODIxMDE2NV5BMl5BanBnXkFtZTcwMTY0MzQyMQ@@._V1._SY314_CR3,0,214,314_.jpg",1993,whats_love_got_to_do_with_it,7.5,33,32,1,96,8.2,7,7,0,100,3.6,9612,83,http://content6.flixster.com/movie/10/90/34/10903400_det.gif,13
531,The Secret Garden,108071,El jardín secreto,"http://ia.media-imdb.com/images/M/MV5BNzEyNTc0NjE0MF5BMl5BanBnXkFtZTcwNTUzNzYxMQ@@._V1._SY314_CR7,0,214,314_.jpg",1993,1045518-secret_garden,8.1,17,16,1,94,0,3,2,1,66,3.3,14794,72,http://content9.flixster.com/movie/11/15/28/11152871_det.jpg,22
4462,18 Again!,94593,Plantón al cielo,"http://ia.media-imdb.com/images/M/MV5BMTQ5Mzk0NjE3M15BMl5BanBnXkFtZTcwNDc2MDkxMQ@@._V1._SY314_CR1,0,214,314_.jpg",1988,18_again,4,7,2,5,28,0,1,0,1,0,2.8,1550,44,http://content7.flixster.com/movie/10/89/20/10892005_det.jpg,-16
2799,Problem Child 2,102719,Este chico es un demonio 2,"http://ia.media-imdb.com/images/M/MV5BMTM3OTYwNTg3OF5BMl5BanBnXkFtZTcwNDc1NDMyMQ@@._V1._SX214_CR0,0,214,314_.jpg",1991,problem_child_2,2.6,12,2,10,16,0,1,0,1,0,0,0,0,http://content7.flixster.com/movie/24/82/39/2482393_det.jpg,16
5685,Real Women Have Curves,296166,Las mujeres de verdad tienen curvas,"http://ia.media-imdb.com/images/M/MV5BMTU5NzkzMDg2M15BMl5BanBnXkFtZTcwNzg2MTQyMQ@@._V1._SY216_CR38,0,214,216_.jpg",2002,real_women_have_curves,6.8,82,68,14,82,7.2,23,21,2,91,3.6,2864,73,http://content9.flixster.com/movie/10/86/58/10865811_det.jpg,9
1701,Deconstructing Harry,118954,Desmontando a Harry,"http://ia.media-imdb.com/images/M/MV5BMjE5MTU1MjA0N15BMl5BanBnXkFtZTcwMzA5NDMyMQ@@._V1._SY314_CR8,0,214,314_.jpg",1997,deconstructing_harry,7.2,33,23,10,69,7.5,6,4,2,66,3.6,5564,79,http://content8.flixster.com/movie/27/09/270998_det.jpg,-10
735,Dellamorte Dellamore,109592,Mi novia es un Zombie,"http://ia.media-imdb.com/images/M/MV5BMTI1ODEzNDA3N15BMl5BanBnXkFtZTcwNDE0MzMzMQ@@._V1._SX214_CR0,0,214,314_.jpg",1994,cemetery_man,6,26,16,10,61,0,2,0,2,0,3.8,3149,78,http://content9.flixster.com/movie/10/87/59/10875991_det.jpg,-17
6093,The Last Unicorn,84237,El último unicornio,"http://ia.media-imdb.com/images/M/MV5BMjEwMDU0MDY0NV5BMl5BanBnXkFtZTYwMTQ2Mjg5._V1._SY303_CR1,0,214,303_.jpg",1982,last_unicorn,5.8,10,5,5,50,0,0,0,0,0,0,0,0,http://content7.flixster.com/movie/25/08/250821_det.jpg,50
5810,8 Mile,298203,8 millas,"http://ia.media-imdb.com/images/M/MV5BMTU2MTgyOTk3MF5BMl5BanBnXkFtZTYwOTg2NTI5._V1._SX214_CR0,0,214,314_.jpg",2002,8_mile,6.7,179,133,46,74,7.2,38,32,6,84,3.1,199023,54,http://content7.flixster.com/movie/26/85/268597_det.jpg,20
2921,High Plains Drifter,68699,Infierno de cobardes,"http://ia.media-imdb.com/images/M/MV5BMTUwMjcxNTM0OF5BMl5BanBnXkFtZTcwODY1MTkxMQ@@._V1._SY314_CR3,0,214,314_.jpg",1973,high_plains_drifter,7.7,23,22,1,95,0,3,2,1,66,3.7,6781,83,http://content9.flixster.com/movie/26/80/268023_det.jpg,12
8524,The High and the Mighty,47086,Escrito en el cielo,"http://ia.media-imdb.com/images/M/MV5BMzc4NzE5NDM5NV5BMl5BanBnXkFtZTcwNjgxOTkyMQ@@._V1._SY314_CR23,0,214,314_.jpg",1954,high_and_the_mighty,5.6,8,3,5,37,0,0,0,0,0,0,0,0,http://content6.flixster.com/movie/96/22/02/9622024_det.jpg,37
55205,Interview,480269,Interview,"http://ia.media-imdb.com/images/M/MV5BMTIwNTA3MTgwNF5BMl5BanBnXkFtZTcwODYxNDk0MQ@@._V1._SX214_CR0,0,214,314_.jpg",2007,10007916_interview,6,121,70,51,57,5.8,31,15,16,48,3.2,14637,53,http://content6.flixster.com/movie/87/30/54/8730548_det.jpg,4
1097,E.T.: The Extra-Terrestrial,83866,"E.T., el extraterrestre","http://ia.media-imdb.com/images/M/MV5BMTc1NTQ0MTUyNF5BMl5BanBnXkFtZTcwMDYzMDU2Mw@@._V1._SX214_CR0,0,214,314_.jpg",1982,et_the_extraterrestrial,8.9,89,87,2,97,8.6,18,17,1,94,3.5,154405,65,http://content8.flixster.com/movie/16/90/48/1690482_det.jpg,32
1328,The Amityville Curse,99030,The Amityville Curse,http://ia.media-imdb.com/images/M/MV5BMjA1MDc5Njk0NF5BMl5BanBnXkFtZTcwNTQ5MDIyMQ@@._V1._SX77_SY140_.jpg,1990,amityville_curse,3.6,5,1,4,20,0,0,0,0,0,0,0,0,http://content7.flixster.com/movie/55/05/10/5505101_det.jpg,20
26462,Bad Boys,112442,Dos policías rebeldes (Bad Boys),"http://ia.media-imdb.com/images/M/MV5BMTI1NzAyNzA3OF5BMl5BanBnXkFtZTYwODU3OTk5._V1._SY314_CR2,0,214,314_.jpg",1995,1062483-bad_boys,4.8,41,16,25,39,3.7,9,1,8,11,3.5,67658,79,http://content8.flixster.com/movie/28/27/282798_det.jpg,-40
7229,Money for Nothing,107594,Que no hacer con un millon de dolares!,"http://ia.media-imdb.com/images/M/MV5BMjA1NTE5OTk5M15BMl5BanBnXkFtZTcwMDA2NjUyMQ@@._V1._SY314_CR4,0,214,314_.jpg",1993,money_for_nothing,0,4,1,3,25,0,1,0,1,0,2.8,839,31,http://content7.flixster.com/movie/10/88/31/10883197_det.jpg,-6
8520,Deep Cover,104073,La cara sucia de la ley,"http://ia.media-imdb.com/images/M/MV5BMTY1NDk4NjQ4M15BMl5BanBnXkFtZTcwMzc1NTYyMQ@@._V1._SY314_CR4,0,214,314_.jpg",1992,1039270-deep_cover,6.6,20,17,3,85,5.8,8,6,2,75,3.4,1559,70,http://content9.flixster.com/movie/10/88/93/10889327_det.jpg,15
37380,Doom,419706,Doom,"http://ia.media-imdb.com/images/M/MV5BMTgzNTEyNjAyNV5BMl5BanBnXkFtZTcwODk0ODIzMQ@@._V1._SX214_CR0,0,214,314_.jpg",2005,doom,3.9,128,24,104,18,3.8,24,4,20,16,2.7,28789,47,http://content9.flixster.com/movie/25/03/250391_det.jpg,-29
8291,Ten Little Indians,61075,Diez negritos,"http://ia.media-imdb.com/images/M/MV5BMTIwNzg4MTAwMl5BMl5BanBnXkFtZTcwMTgxODIzMQ@@._V1._SY314_CR32,0,214,314_.jpg",1965,1045403-ten_little_indians,0,1,0,1,0,0,0,0,0,0,0,0,0,http://content7.flixster.com/movie/10/91/72/10917265_det.jpg,0
26301,Save the Tiger,70640,Salvad al tigre,"http://ia.media-imdb.com/images/M/MV5BMTI0NzE4MDU4NV5BMl5BanBnXkFtZTcwODQwMTEzMQ@@._V1._SY314_CR4,0,214,314_.jpg",1973,save_the_tiger,7,10,9,1,90,0,1,1,0,100,3.5,617,63,http://content9.flixster.com/movie/26/74/267491_det.jpg,27
6580,Amores Possíveis,275915,Amores Possíveis,"http://ia.media-imdb.com/images/M/MV5BODY5NTA0NTA1MF5BMl5BanBnXkFtZTcwMjE3OTYyMQ@@._V1._SY314_CR4,0,214,314_.jpg",2001,possible_loves,0,2,2,0,100,0,0,0,0,0,0,0,0,http://content6.flixster.com/movie/30/49/304904_det.jpg,100
3231,The Saphead,11652,Ingenuo y afortunado,"http://ia.media-imdb.com/images/M/MV5BMTI5NTc0ODAzMF5BMl5BanBnXkFtZTYwNTU3NDg4._V1._SY314_CR8,0,214,314_.jpg",1920,saphead,0,0,0,0,0,0,0,0,0,0,0,0,0,http://content7.flixster.com/movie/10/87/92/10879209_det.jpg,0
130,Angela's Ashes,145653,Las cenizas de Ángela,"http://ia.media-imdb.com/images/M/MV5BMTg3NDg0NjU5OF5BMl5BanBnXkFtZTcwMjAwMjIyMQ@@._V1._SY314_CR3,0,214,314_.jpg",1999,angelas_ashes,5.7,84,44,40,52,5.3,26,10,16,38,3.6,4588,79,http://content6.flixster.com/movie/10/92/31/10923132_det.jpg,-27
7243,Intolerance: Love's Struggle Throughout the Ages,6864,Intolerancia,"http://ia.media-imdb.com/images/M/MV5BODEyNDUyODE3N15BMl5BanBnXkFtZTcwNTcyMjkyMQ@@._V1._SY314_CR2,0,214,314_.jpg",1916,1010644-intolerance,7.8,23,22,1,95,0,3,3,0,100,3.8,1397,77,http://content6.flixster.com/movie/31/14/311408_det.jpg,18
8033,How to Steal a Million,60522,Cómo robar un millón y...,"http://ia.media-imdb.com/images/M/MV5BMjE2NzY3OTI0OF5BMl5BanBnXkFtZTcwMzg0MDcyMQ@@._V1._SY314_CR3,0,214,314_.jpg",1966,how_to_steal_a_million,7,6,6,0,100,0,0,0,0,0,0,0,0,http://content6.flixster.com/movie/28/58/285804_det.jpg,100
7024,Salò o le 120 giornate di Sodoma,73650,Saló o los 120 días de Sodoma,"http://ia.media-imdb.com/images/M/MV5BMjA5OTI3NzgyMl5BMl5BanBnXkFtZTcwOTgwMDYxMQ@@._V1._SY314_CR5,0,214,314_.jpg",1975,salo,6.1,21,15,6,71,0,2,1,1,50,3.6,4630,68,http://content7.flixster.com/movie/10/93/75/10937577_det.jpg,3
4288,Pola X,152015,Pola X,"http://ia.media-imdb.com/images/M/MV5BMTg2ODYyODUwNl5BMl5BanBnXkFtZTcwNzA5NDEyMQ@@._V1._SY314_CR3,0,214,314_.jpg",1999,pola_x,6.6,20,15,5,75,6.9,7,6,1,85,3.3,449,54,http://content9.flixster.com/movie/29/59/295995_det.jpg,21
801,Harriet the Spy,116493,Harriet the Spy,"http://ia.media-imdb.com/images/M/MV5BMTg5NzUzODA5MV5BMl5BanBnXkFtZTcwOTAwNTAzMQ@@._V1._SY314_CR2,0,214,314_.jpg",1996,1072990-harriet_the_spy,5.1,29,13,16,44,4.8,13,4,9,30,2.6,3584,46,http://content6.flixster.com/movie/10/86/90/10869000_det.jpg,-2
1150,Le retour de Martin Guerre,84589,El regreso de Martin Guerre,"http://ia.media-imdb.com/images/M/MV5BMTU4NzQxMDkxMV5BMl5BanBnXkFtZTcwODA4NTUyMQ@@._V1._SY314_CR4,0,214,314_.jpg",1982,the-return-of-martin-guerre,8,9,9,0,100,0,0,0,0,0,0,0,0,http://content9.flixster.com/movie/29/94/299491_det.jpg,100
4532,Return of the Living Dead Part II,95990,Return of the Living Dead Part II,"http://ia.media-imdb.com/images/M/MV5BMTMyNTY2NTc5N15BMl5BanBnXkFtZTYwMTU0OTg5._V1._SX214_CR0,0,214,314_.jpg",1988,return_of_the_living_dead_2,3.3,13,0,13,0,0,1,0,1,0,2.9,4031,47,http://content8.flixster.com/movie/55/37/50/5537506_det.jpg,-47
3480,Lucas,91445,Lucas,"http://ia.media-imdb.com/images/M/MV5BMTY4NTM1ODEzOF5BMl5BanBnXkFtZTYwNDk0NDk5._V1._SY314_CR4,0,214,314_.jpg",1986,lucas,6.2,14,9,5,64,0,2,2,0,100,3.3,2546,66,http://content8.flixster.com/movie/25/88/258830_det.jpg,-2
7842,Dune,87182,Dune,"http://ia.media-imdb.com/images/M/MV5BMTU3MjQzNjMxMF5BMl5BanBnXkFtZTcwMjIwNDgyMQ@@._V1._SY314_CR4,0,214,314_.jpg",1984,1006364-dune,6.1,26,16,10,61,0,2,0,2,0,3.4,17715,67,http://content7.flixster.com/movie/11/13/64/11136477_det.jpg,-6
62644,Die Welle,1063669,La ola,"http://ia.media-imdb.com/images/M/MV5BODIzODYzNTM4OF5BMl5BanBnXkFtZTcwOTQ5MjQ4MQ@@._V1._SY314_CR4,0,214,314_.jpg",2008,1206901-wave,5.8,13,9,4,69,0,1,1,0,100,3.9,4370,83,http://content8.flixster.com/movie/10/84/05/10840550_det.jpg,-14
7949,The Yakuza,73918,The Yakuza,"http://ia.media-imdb.com/images/M/MV5BNzE1NzM5ODI2NV5BMl5BanBnXkFtZTcwNTE2ODI0MQ@@._V1._SY314_CR21,0,214,314_.jpg",1974,yakuza,5.8,10,5,5,50,0,3,0,3,0,3.8,480,79,http://content8.flixster.com/movie/50/40/69/5040694_det.jpg,-29
3055,Felicia's Journey,165773,El viaje de Felicia,"http://ia.media-imdb.com/images/M/MV5BMTAwNjY2MTgzMDReQTJeQWpwZ15BbWU3MDMwNTgyMjE@._V1._SY314_CR8,0,214,314_.jpg",1999,felicias_journey,7.4,40,35,5,87,7.8,8,8,0,100,3.4,694,66,http://content8.flixster.com/movie/26/34/263494_det.jpg,21
58,Il postino,110877,El cartero (y Pablo Neruda),"http://ia.media-imdb.com/images/M/MV5BMTkxNTc5NjE0NV5BMl5BanBnXkFtZTcwMTI2MTYyMQ@@._V1._SY301_CR1,0,214,301_.jpg",1994,il_postino,7.9,25,23,2,92,0,4,4,0,100,4.1,5794,92,http://content8.flixster.com/movie/10/86/74/10867406_det.jpg,0
3359,Breaking Away,78902,El relevo,"http://ia.media-imdb.com/images/M/MV5BMTA1NTE0NDU4MTFeQTJeQWpwZ15BbWU3MDEwODEzNTE@._V1._SY314_CR2,0,214,314_.jpg",1979,breaking_away,8.2,33,31,2,93,8.3,5,5,0,100,3.9,2650,84,http://content8.flixster.com/movie/10/91/67/10916770_det.jpg,9
47122,John Tucker Must Die,455967,Todas contra él,"http://ia.media-imdb.com/images/M/MV5BMTI2MjAyOTI0N15BMl5BanBnXkFtZTcwMTQ5MTkzMQ@@._V1._SY314_CR7,0,214,314_.jpg",2006,john_tucker_must_die,4.3,92,23,69,25,4.2,26,4,22,15,3.6,194452,74,http://content7.flixster.com/movie/10/87/26/10872657_det.jpg,-49
6355,Les Girls,50631,Les Girls,"http://ia.media-imdb.com/images/M/MV5BMjExNDk3MjY1N15BMl5BanBnXkFtZTYwNzEwNzk5._V1._SY314_CR5,0,214,314_.jpg",1957,les_girls,0,4,4,0,100,0,0,0,0,0,0,0,0,http://content8.flixster.com/movie/10/87/82/10878294_det.jpg,100
433,Clean Slate,109443,Borrón y cuenta nueva,"http://ia.media-imdb.com/images/M/MV5BNjU0NTkwMTQ0OF5BMl5BanBnXkFtZTcwNTYwMTUyMQ@@._V1._SY314_CR3,0,214,314_.jpg",1994,1050560-clean_slate,4.1,16,3,13,18,0,2,0,2,0,2.5,630,33,http://content6.flixster.com/movie/26/42/264200_det.jpg,-15
3225,Down to You,186975,Esta chica me pone,"http://ia.media-imdb.com/images/M/MV5BMTI3NDIxMTIwMF5BMl5BanBnXkFtZTcwNTQ3MTIyMQ@@._V1._SY314_CR3,0,214,314_.jpg",2000,down_to_you,3.2,58,2,56,3,2.8,16,0,16,0,2.7,6516,51,http://content7.flixster.com/movie/25/95/259521_det.jpg,-48
932,An Affair to Remember,50105,Tú y yo,"http://ia.media-imdb.com/images/M/MV5BMjE1NjE3MDA1MV5BMl5BanBnXkFtZTYwMTMyNDg5._V1._SX214_CR0,0,214,314_.jpg",1957,affair_to_remember,6.4,25,16,9,64,0,1,0,1,0,4,7962,88,http://content6.flixster.com/movie/30/79/307928_det.jpg,-24
927,The Women,430770,The Women,"http://ia.media-imdb.com/images/M/MV5BMjIwNjg2MTk1MV5BMl5BanBnXkFtZTcwODQxMzk3MQ@@._V1._SX214_CR0,0,214,314_.jpg",2008,10009516-women,3.9,142,18,124,12,3.8,34,4,30,11,3,20081,41,http://content6.flixster.com/movie/10/85/30/10853064_det.jpg,-29
42004,Transamerica,407265,Transamérica,"http://ia.media-imdb.com/images/M/MV5BMTQwMjExNzkzMV5BMl5BanBnXkFtZTcwMjczNjEzMQ@@._V1._SX214_CR0,0,214,314_.jpg",2005,transamerica,6.8,134,102,32,76,6.8,35,27,8,77,3.6,21396,77,http://content9.flixster.com/movie/52/17/521767_det.jpg,-1
8292,Hakuchi,43614,El idiota,"http://ia.media-imdb.com/images/M/MV5BMjA5NjUyODI3OF5BMl5BanBnXkFtZTcwMjIyMTU1MQ@@._V1._SY314_CR16,0,214,314_.jpg",1951,Hakuchi,7,7,6,1,85,0,0,0,0,0,0,0,0,http://content6.flixster.com/movie/40/82/04/4082048_det.jpg,85
3901,Duets,134630,A dúo,"http://ia.media-imdb.com/images/M/MV5BMTcwNTIxMjg5OV5BMl5BanBnXkFtZTcwNjIxODgyMQ@@._V1._SY314_CR10,0,214,314_.jpg",2000,1100086-duets,3.9,88,18,70,20,3.9,25,5,20,20,2.9,2253,44,http://content7.flixster.com/movie/26/98/269817_det.jpg,-24
1880,Lawn Dogs,119506,Inocencia rebelde (Lawn Dogs),"http://ia.media-imdb.com/images/M/MV5BMTI3NDA4NzcyNV5BMl5BanBnXkFtZTcwMTMzMjMyMQ@@._V1._SY314_CR1,0,214,314_.jpg",1997,lawn_dogs,6.5,18,13,5,72,0,4,1,3,25,3.8,1154,84,http://content7.flixster.com/movie/27/69/276997_det.jpg,-12
954,Mr. Smith Goes to Washington,31679,Caballero sin espada,"http://ia.media-imdb.com/images/M/MV5BMTk4OTk2ODI5M15BMl5BanBnXkFtZTcwMzAyMTEzMQ@@._V1._SY314_CR6,0,214,314_.jpg",1939,can-mr-smith-get-to-washington-anymore,7.4,12,10,2,83,7.4,7,6,1,85,3.6,869,66,http://content8.flixster.com/movie/10/86/77/10867718_det.jpg,17
4315,Gabriela,189541,Gabriela,"http://ia.media-imdb.com/images/M/MV5BMTI3MDAwNDE3MF5BMl5BanBnXkFtZTcwNDkxNjQyMQ@@._V1._SY314_CR3,0,214,314_.jpg",2001,1114093-gabriela,0,2,0,2,0,0,0,0,0,0,0,0,0,http://content9.flixster.com/movie/28/37/283799_det.jpg,0
6524,Pote tin Kyriaki,54198,Nunca en domingo,"http://ia.media-imdb.com/images/M/MV5BMTI1NTg3NzA4Ml5BMl5BanBnXkFtZTYwMTU4Njk5._V1._SY314_CR2,0,214,314_.jpg",1960,1014832-never_on_sunday,6.8,7,6,1,85,0,0,0,0,0,0,0,0,http://content6.flixster.com/movie/29/47/294796_det.jpg,85
1693,Amistad,118607,Amistad,"http://ia.media-imdb.com/images/M/MV5BMTU4OTE4MzQzN15BMl5BanBnXkFtZTcwNjQyNDgyMQ@@._V1._SX214_CR0,0,214,314_.jpg",1997,amistad,6.9,57,44,13,77,6.6,10,6,4,60,3.5,9716,75,http://content6.flixster.com/movie/26/82/268208_det.jpg,2
4976,Iris,280778,Iris,"http://ia.media-imdb.com/images/M/MV5BMTMxMjQ3NjQ3MF5BMl5BanBnXkFtZTcwNTc4NDEzMQ@@._V1._SY314_CR1,0,214,314_.jpg",2001,1111227-iris,7.1,109,86,23,78,7.6,34,29,5,85,3.6,2908,73,http://content9.flixster.com/movie/10/89/08/10890895_det.jpg,5
7833,Shadow of the Thin Man,34172,Shadow of the Thin Man,"http://ia.media-imdb.com/images/M/MV5BNDkyNDM5ODY5Ml5BMl5BanBnXkFtZTcwNzAzMTkyMQ@@._V1._SY314_CR8,0,214,314_.jpg",1941,shadow_of_the_thin_man,6.8,6,5,1,83,0,0,0,0,0,0,0,0,http://content8.flixster.com/movie/65/86/29/6586290_det.jpg,83
6496,Éxtasis,118239,Éxtasis,"http://ia.media-imdb.com/images/M/MV5BMTU2MTM3MjEwOF5BMl5BanBnXkFtZTcwNDg0MzMzMQ@@._V1._SY314_CR3,0,214,314_.jpg",1996,extasis_2008,0,0,0,0,0,0,0,0,0,0,0,0,0,http://content7.flixster.com/movie/10/85/07/10850769_det.jpg,0
117,The Young Poisoner's Handbook,115033,The Young Poisoner's Handbook,"http://ia.media-imdb.com/images/M/MV5BMTk4NzI4OTk4NF5BMl5BanBnXkFtZTYwMzU4Mjg5._V1._SY216_CR41,0,214,216_.jpg",1995,young_poisoners_handbook,7.1,13,11,2,84,0,3,3,0,100,3.7,541,79,http://content8.flixster.com/movie/52/63/47/5263478_det.jpg,5
2057,Homeward Bound: The Incredible Journey,107131,"De vuelta a casa, un viaje increíble","http://ia.media-imdb.com/images/M/MV5BMTM3NDEyMzU5N15BMl5BanBnXkFtZTcwODA2MzQyMQ@@._V1._SY314_CR5,0,214,314_.jpg",1993,homeward_bound_the_incredible_journey,6.5,22,19,3,86,6.9,8,7,1,87,3.2,15019,66,http://content8.flixster.com/movie/10/91/53/10915370_det.jpg,20
3260,Howards End,104454,Regreso a Howards End,"http://ia.media-imdb.com/images/M/MV5BMTc3NzYzOTM3OV5BMl5BanBnXkFtZTcwODUxMjU3Mg@@._V1._SY314_CR17,0,214,314_.jpg",1992,howards_end,8.2,34,31,3,91,9.8,5,5,0,100,3.7,3467,80,http://content8.flixster.com/movie/10/93/46/10934662_det.jpg,11
6042,Im toten Winkel - Hitlers Sekretärin,311320,Im toten Winkel - Hitlers Sekretärin,"http://ia.media-imdb.com/images/M/MV5BNjQwODk0MTIyMF5BMl5BanBnXkFtZTcwMzk0MzQyMQ@@._V1._SY314_CR2,0,214,314_.jpg",2002,blind_spot_hitlers_secretary,7.3,80,68,12,85,7.7,27,26,1,96,3.4,472,66,http://content8.flixster.com/movie/25/93/259318_det.jpg,19
33608,December 7th,35790,December 7th,"http://ia.media-imdb.com/images/M/MV5BODk4NTE2OTExOF5BMl5BanBnXkFtZTcwNDAxMzgzMQ@@._V1._SY314_CR50,0,214,314_.jpg",1943,december-7th-1942,0,0,0,0,0,0,0,0,0,0,0,0,0,http://content9.flixster.com/movie/10/91/88/10918859_det.jpg,0
6082,The Grey Fox,85622,El Zorro gris,"http://ia.media-imdb.com/images/M/MV5BMTg1MjU2OTI5MV5BMl5BanBnXkFtZTcwNTE4MzAzMQ@@._V1._SX214_CR0,0,214,314_.jpg",1982,grey_fox,7.1,12,12,0,100,0,1,1,0,100,3.5,162,64,http://content7.flixster.com/movie/10/85/27/10852757_det.jpg,36
5742,First Monday in October,82382,Mi querida señor juez,"http://ia.media-imdb.com/images/M/MV5BMjE4MzYyMDg1MV5BMl5BanBnXkFtZTcwNjcxODUyMQ@@._V1._SY314_CR4,0,214,314_.jpg",1981,first_monday_in_october,0,4,1,3,25,0,0,0,0,0,0,0,0,http://content7.flixster.com/movie/27/30/273005_det.jpg,25
6062,Lost in La Mancha,308514,Lost in La Mancha,"http://ia.media-imdb.com/images/M/MV5BMjExNzY1ODUwM15BMl5BanBnXkFtZTcwOTg1MTQyMQ@@._V1._SX214_CR0,0,214,314_.jpg",2002,lost_in_la_mancha,7.5,97,91,6,93,7.4,25,22,3,88,3.6,5216,72,http://content7.flixster.com/movie/10/93/78/10937849_det.jpg,21
8004,Terrore nello spazio,59792,Terror en el espacio,"http://ia.media-imdb.com/images/M/MV5BMjA4NzY0NTY0Ml5BMl5BanBnXkFtZTcwODkzODkyMQ@@._V1._SX214_CR0,0,214,314_.jpg",1965,planet_of_the_vampires,5.9,7,4,3,57,0,0,0,0,0,0,0,0,http://content6.flixster.com/movie/10/91/34/10913492_det.jpg,57
718,Les visiteurs,108500,Los visitantes,"http://ia.media-imdb.com/images/M/MV5BMjAzNzAxMDE4Ml5BMl5BanBnXkFtZTcwMTE0MjgzMg@@._V1._SY314_CR1,0,214,314_.jpg",1993,1073317-visitors,5.4,11,4,7,36,0,3,0,3,0,3.7,3693,74,http://content6.flixster.com/movie/34/10/61/3410616_det.jpg,-38
1105,Children of the Corn: The Gathering,115885,Children of the Corn: The Gathering,"http://ia.media-imdb.com/images/M/MV5BMTQxOTY3NTEzMV5BMl5BanBnXkFtZTcwMjA2MDAyMQ@@._V1._SY314_CR4,0,214,314_.jpg",1996,children_of_the_corn_iv_the_gathering,0,1,0,1,0,0,0,0,0,0,0,0,0,http://content8.flixster.com/movie/10/91/84/10918478_det.jpg,0
4262,Scarface,86250,El precio del poder (Scarface),"http://ia.media-imdb.com/images/M/MV5BMTQ5NzI3OTQ3NF5BMl5BanBnXkFtZTcwODczMjMzMQ@@._V1._SY314_CR3,0,214,314_.jpg",1983,1018324-scarface,7.5,50,44,6,88,8,5,4,1,80,4.1,121090,93,http://content6.flixster.com/movie/49/68/81/4968812_det.jpg,-5
2380,Police Academy 3: Back in Training,91777,Loca academia de policía III,"http://ia.media-imdb.com/images/M/MV5BMzkzNTkzNTI2Nl5BMl5BanBnXkFtZTcwNzkwMDUyMQ@@._V1._SY314_CR21,0,214,314_.jpg",1986,police_academy_3_back_in_training,4.2,10,4,6,40,0,1,1,0,100,2.8,6533,49,http://content9.flixster.com/movie/10/92/26/10922667_det.jpg,-9
6152,Il mondo di Yor,84935,"Yor, el cazador que vino del futuro","http://ia.media-imdb.com/images/M/MV5BMTU5NDQyNDg2OF5BMl5BanBnXkFtZTcwNjQ4MTEyMQ@@._V1._SX214_CR0,0,214,314_.jpg",1983,yor_the_hunter_from_the_future,2.8,5,1,4,20,0,0,0,0,0,0,0,0,http://content8.flixster.com/movie/70/51/73/7051730_det.jpg,20
2143,Legend,89469,Legend,"http://ia.media-imdb.com/images/M/MV5BMjA1MzE5OTg3NF5BMl5BanBnXkFtZTcwNjk5ODgyMQ@@._V1._SY314_CR3,0,214,314_.jpg",1985,1012164-legend,5.4,21,11,10,52,0,1,0,1,0,3.5,26271,73,http://content6.flixster.com/movie/25/40/254000_det.jpg,-21
8378,Doctor Who,116118,Doctor Who,"http://ia.media-imdb.com/images/M/MV5BMTU1NDMxOTU0Ml5BMl5BanBnXkFtZTcwNzU0NjQyMQ@@._V1._SX214_CR0,0,214,314_.jpg",1996,doctor-who,0,0,0,0,0,0,0,0,0,0,0,0,0,http://content8.flixster.com/movie/65/85/89/6585890_det.jpg,0
4367,Lara Croft: Tomb Raider,146316,Tomb Raider,"http://ia.media-imdb.com/images/M/MV5BNzgwMDcwNzk1NV5BMl5BanBnXkFtZTYwNzY2OTY5._V1._SX214_CR0,0,214,314_.jpg",2001,lara_croft_tomb_raider,3.9,154,29,125,18,3.9,35,7,28,20,3.1,46926,60,http://content8.flixster.com/movie/10/87/58/10875862_det.jpg,-42
6865,Lemony Snicket's A Series of Unfortunate Events,339291,Una serie de catastróficas desdichas de Lemony Snicket,"http://ia.media-imdb.com/images/M/MV5BMjE3MDM4NTg0NV5BMl5BanBnXkFtZTcwNjI4MTczMw@@._V1._SX214_CR0,0,214,314_.jpg",2004,lemony_snicket,6.6,154,109,45,70,6.6,32,19,13,59,3.2,60437,61,http://content8.flixster.com/movie/40/88/39/4088394_det.jpg,9
443,The Endless Summer 2,109729,The Endless Summer 2,"http://ia.media-imdb.com/images/M/MV5BMTk4ODE2OTA1Nl5BMl5BanBnXkFtZTcwMDQ2ODkxMQ@@._V1._SY314_CR3,0,214,314_.jpg",1994,endless_summer_ii_the_the_journey_continues,5.8,14,8,6,57,5,5,2,3,40,4,802,89,http://content6.flixster.com/movie/25/72/257204_det.jpg,-32
1474,Jungle 2 Jungle,119432,De jungla a jungla,"http://ia.media-imdb.com/images/M/MV5BMTU0NDk2ODUzMl5BMl5BanBnXkFtZTcwMTc1NjkyMQ@@._V1._SY314_CR3,0,214,314_.jpg",1997,jungle_2_jungle,4,39,7,32,17,4.2,13,3,10,23,2.7,9218,44,http://content9.flixster.com/movie/25/96/259695_det.jpg,-27
4521,Little Nikita,95532,Espías sin identidad,"http://ia.media-imdb.com/images/M/MV5BMjEwNjEzNTg5NF5BMl5BanBnXkFtZTcwMjkzMzgxMQ@@._V1._SX214_CR0,0,214,314_.jpg",1988,little_nikita,5.7,7,6,1,85,0,1,0,1,0,3.1,1024,47,http://content7.flixster.com/movie/26/36/263609_det.jpg,38
4060,Love Field,104765,Por encima de todo,"http://ia.media-imdb.com/images/M/MV5BMjE1Nzk4ODM0Ml5BMl5BanBnXkFtZTcwOTU3ODUyMQ@@._V1._SY314_CR3,0,214,314_.jpg",1992,love_field,5.7,10,5,5,50,0,3,0,3,0,3.2,596,48,http://content9.flixster.com/movie/26/32/263291_det.jpg,2
3590,The Lord's of Flatbush,71772,Black jackets. Días felices,"http://ia.media-imdb.com/images/M/MV5BMTg4NjAxOTczOF5BMl5BanBnXkFtZTcwMDY2MjIyMQ@@._V1._SX214_CR0,0,214,314_.jpg",1974,lords_of_flatbush,5.6,11,7,4,63,0,3,0,3,0,3.1,800,43,http://content8.flixster.com/movie/26/01/260194_det.jpg,20
4966,The Incredible Shrinking Man,50539,El increíble hombre menguante,"http://ia.media-imdb.com/images/M/MV5BMTMwNzE5NjE0Nl5BMl5BanBnXkFtZTcwMjY2MDEyMQ@@._V1._SX214_CR0,0,214,314_.jpg",1957,incredible_shrinking_man,7.6,16,14,2,87,0,2,1,1,50,3.7,997,80,http://content8.flixster.com/movie/34/46/85/3446858_det.jpg,7
7839,Crazy Love,790706,Crazy Love,"http://ia.media-imdb.com/images/M/MV5BMTUyNjcwMTYwOV5BMl5BanBnXkFtZTcwMTA4OTc0MQ@@._V1._SX214_CR0,0,214,314_.jpg",2007,10007792-crazy_love,7,84,65,19,77,7,32,26,6,81,3.6,2624,70,http://content6.flixster.com/movie/10/53/69/10536956_det.jpg,7
1694,The Apostle,118632,Camino al cielo,"http://ia.media-imdb.com/images/M/MV5BMjA1NzUyMTg0OF5BMl5BanBnXkFtZTcwMzY1NTUyMQ@@._V1._SY314_CR4,0,214,314_.jpg",1997,apostle,8,44,40,4,90,8,10,9,1,90,3.6,2049,75,http://content8.flixster.com/movie/26/41/264198_det.jpg,15
3775,Make Mine Music,38718,Make Mine Music,"http://ia.media-imdb.com/images/M/MV5BMTI3NzMzNzQ1OV5BMl5BanBnXkFtZTcwMjM5NDYxMQ@@._V1._SX214_CR0,0,214,314_.jpg",1946,make_mine_music,6.3,9,6,3,66,0,3,1,2,33,3.1,777,46,http://content6.flixster.com/movie/10/87/88/10878876_det.jpg,20
6181,The Red Badge of Courage,43961,Medalla roja al valor,"http://ia.media-imdb.com/images/M/MV5BMTIyODUyODY4NV5BMl5BanBnXkFtZTcwNTAzNTAzMQ@@._V1._SY314_CR1,0,214,314_.jpg",1951,red_badge_of_courage,7.6,9,8,1,88,0,0,0,0,0,0,0,0,http://content8.flixster.com/movie/10/88/23/10882366_det.jpg,88
3833,The Brain That Wouldn't Die,52646,The Brain That Wouldn't Die,"http://ia.media-imdb.com/images/M/MV5BNTkwODc2ODA5NF5BMl5BanBnXkFtZTcwODQxNTA0MQ@@._V1._SY314_CR3,0,214,314_.jpg",1962,brain-that-wouldnt-die,4.2,11,4,7,36,0,0,0,0,0,0,0,0,http://content9.flixster.com/movie/10/93/53/10935331_det.jpg,36
6518,Flight of the Intruder,99587,El vuelo del Intruder,"http://ia.media-imdb.com/images/M/MV5BMTczMTY5OTQ2M15BMl5BanBnXkFtZTcwMzkyNjIyMQ@@._V1._SY314_CR3,0,214,314_.jpg",1991,flight_of_the_intruder,4.3,11,3,8,27,0,2,0,2,0,3,858,50,http://content9.flixster.com/movie/10/87/58/10875891_det.jpg,-23
1971,A Nightmare on Elm Street 4: The Dream Master,95742,Pesadilla en Elm Street 4,"http://ia.media-imdb.com/images/M/MV5BODMxODAzMDU2MV5BMl5BanBnXkFtZTcwMzIzMzAyMQ@@._V1._SY314_CR5,0,214,314_.jpg",1988,nightmare_on_elm_street_4_the_dream_master,5.3,25,14,11,56,0,4,2,2,50,3,19043,60,http://content6.flixster.com/movie/10/95/40/10954012_det.jpg,-4
4316,Ice Castles,77716,Castillos de hielo,"http://ia.media-imdb.com/images/M/MV5BNzY1NDE1Mzg0Nl5BMl5BanBnXkFtZTYwMjA3Njg5._V1._SX214_CR0,0,214,314_.jpg",1978,ice_castles,5.2,7,3,4,42,0,1,0,1,0,3.5,1225,71,http://content8.flixster.com/movie/25/62/256218_det.jpg,-29
26803,Änglagård,105916,Änglagård,"http://ia.media-imdb.com/images/M/MV5BMTA3MjA3Mjg2MzNeQTJeQWpwZ15BbWU3MDM1MjMzMzE@._V1._SY314_CR5,0,214,314_.jpg",1992,house_of_angels,7.2,5,4,1,80,0,1,1,0,100,3.7,254,72,http://content9.flixster.com/movie/10/12/14/10121423_det.jpg,8
27674,11:14,331811,11:14,"http://ia.media-imdb.com/images/M/MV5BMjEwODEyOTIyOF5BMl5BanBnXkFtZTcwNzQ4NjEzMQ@@._V1._SY314_CR0,0,214,314_.jpg",2003,1114,6.8,11,11,0,100,0,1,1,0,100,3.6,6342,75,http://content8.flixster.com/movie/58/27/59/5827590_det.jpg,25
64997,War of the Worlds,407304,La guerra de los mundos,"http://ia.media-imdb.com/images/M/MV5BNDUyODAzNDI1Nl5BMl5BanBnXkFtZTcwMDA2NDAzMw@@._V1._SX214_CR0,0,214,314_.jpg",2005,war_of_the_worlds,7,244,178,66,72,6.7,42,28,14,66,2.9,162092,45,http://content8.flixster.com/movie/10/86/82/10868202_det.jpg,27
328,Tales from the Crypt: Demon Knight,114608,Caballero del diablo,"http://ia.media-imdb.com/images/M/MV5BMTkzOTY2MDUzMV5BMl5BanBnXkFtZTcwNTIyOTgyMQ@@._V1._SY314_CR7,0,214,314_.jpg",1995,tales_from_the_crypt_presents_demon_knight,4,23,7,16,30,3.4,7,1,6,14,3.2,4989,63,http://content9.flixster.com/movie/10/88/79/10887979_det.jpg,-33
5997,Champagne for Caesar,42325,Champagne for Caesar,"http://ia.media-imdb.com/images/M/MV5BMTc2MDkwNzE0Ml5BMl5BanBnXkFtZTcwNTc3ODgxMQ@@._V1._SY314_CR4,0,214,314_.jpg",1950,champagne_for_caesar,0,3,3,0,100,0,0,0,0,0,0,0,0,http://content6.flixster.com/movie/10/86/68/10866884_det.jpg,100
1388,Jaws,73195,Tiburón,"http://ia.media-imdb.com/images/M/MV5BMzcyMTQyOTU0Nl5BMl5BanBnXkFtZTcwNDY0NzE5Mw@@._V1._SY314_CR5,0,214,314_.jpg",1975,jaws,8.8,37,37,0,100,8.5,5,5,0,100,3.5,63534,81,http://content7.flixster.com/movie/10/93/72/10937249_det.jpg,19
8980,Notre musique,360845,Nuestra música,"http://ia.media-imdb.com/images/M/MV5BMTkxNTk0MzMwMF5BMl5BanBnXkFtZTcwNDI0NDcyMQ@@._V1._SY314_CR2,0,214,314_.jpg",2004,notre_musique,6.6,54,36,18,66,6.9,17,12,5,70,3.7,949,69,http://content9.flixster.com/movie/29/50/295091_det.jpg,-3
5747,Gallipoli,82432,Gallipoli,"http://ia.media-imdb.com/images/M/MV5BMTIwMDI4MjE2N15BMl5BanBnXkFtZTcwMDU0NzEzMQ@@._V1._SX214_CR0,0,214,314_.jpg",1981,1008074-gallipoli,7.4,21,18,3,85,0,2,1,1,50,3.6,5646,77,http://content9.flixster.com/movie/26/00/260095_det.jpg,8
4704,Hatari!,56059,¡Hatari!,"http://ia.media-imdb.com/images/M/MV5BMTg5ODY4NDcxOV5BMl5BanBnXkFtZTcwOTU3OTEyMQ@@._V1._SY314_CR4,0,214,314_.jpg",1962,hatari,6.6,22,15,7,68,0,4,3,1,75,3.7,1953,75,http://content8.flixster.com/movie/29/12/291226_det.jpg,-7
4323,The Horse Soldiers,52902,Misión de audaces,http://ia.media-imdb.com/images/M/MV5BMTI3MTIwNTA2MV5BMl5BanBnXkFtZTcwNTk1MzUyMQ@@._V1._SX100_SY140_.jpg,1959,horse_soldiers,7.4,5,5,0,100,0,0,0,0,0,0,0,0,http://content6.flixster.com/movie/10/87/81/10878152_det.jpg,100
4899,Black Knight,265087,El caballero negro,"http://ia.media-imdb.com/images/M/MV5BMjE4MTIzMTAxM15BMl5BanBnXkFtZTcwOTAyMDMyMQ@@._V1._SY314_CR3,0,214,314_.jpg",2001,black_knight,3.4,94,12,82,12,3.8,27,6,21,22,2.6,9124,46,http://content7.flixster.com/movie/18/68/31/1868317_det.jpg,-34
6373,Evan Almighty,413099,Sigo como dios,"http://ia.media-imdb.com/images/M/MV5BMTUxMTEzODYxMV5BMl5BanBnXkFtZTcwNzQ4ODU0MQ@@._V1._SX214_CR0,0,214,314_.jpg",2007,evan_almighty,4.5,190,44,146,23,4,39,3,36,7,3.2,369422,56,http://content8.flixster.com/movie/62/22/37/6222374_det.jpg,-33
1152,He Walked by Night,40427,Orden: Caza sin cuartel,"http://ia.media-imdb.com/images/M/MV5BMTM2MTc3MjU4Ml5BMl5BanBnXkFtZTcwMjYwMzQyMQ@@._V1._SY314_CR15,0,214,314_.jpg",1948,he_walked_by_night,7.6,6,5,1,83,0,0,0,0,0,0,0,0,http://content8.flixster.com/movie/10/33/53/10335338_det.jpg,83
4191,Alfie,375173,Alfie,"http://ia.media-imdb.com/images/M/MV5BNzU0NjgyNjM0N15BMl5BanBnXkFtZTcwMTEwMDgyMQ@@._V1._SY314_CR4,0,214,314_.jpg",2004,alfie,5.5,149,73,76,48,5.2,38,16,22,42,2.9,15367,49,http://content9.flixster.com/movie/27/01/270103_det.jpg,-1
26745,Other People's Money,102609,Con el dinero de los demás,"http://ia.media-imdb.com/images/M/MV5BMTI2OTkyODAyMV5BMl5BanBnXkFtZTcwMTM2NDcyMQ@@._V1._SY314_CR19,0,214,314_.jpg",1991,other_peoples_money,4.6,14,5,9,35,0,2,1,1,50,2.8,936,42,http://content7.flixster.com/movie/10/87/34/10873433_det.jpg,-7
1525,Warriors of Virtue,120479,Guerreros de la virtud,"http://ia.media-imdb.com/images/M/MV5BNDAxNzEzOTA0OF5BMl5BanBnXkFtZTcwMjU1MjEzMQ@@._V1._SY314_CR4,0,214,314_.jpg",1997,warriors_of_virtue,4,10,1,9,10,0,4,0,4,0,2.9,927,45,http://content8.flixster.com/movie/26/48/264814_det.jpg,-35
1032,Alice in Wonderland,43274,Alicia en el país de las maravillas,"http://ia.media-imdb.com/images/M/MV5BMzc4NzE1NjUxNV5BMl5BanBnXkFtZTcwNzc2NDQyMQ@@._V1._SY314_CR3,0,214,314_.jpg",1951,1029112-alice_in_wonderland,6.5,22,18,4,81,0,3,2,1,66,3.3,37778,70,http://content8.flixster.com/movie/10/83/99/10839910_det.jpg,11
2337,Velvet Goldmine,120879,Velvet Goldmine,"http://ia.media-imdb.com/images/M/MV5BMTQ4NTI0MTExOV5BMl5BanBnXkFtZTcwMzQ2NjY5Mw@@._V1._SX214_CR0,0,214,314_.jpg",1998,velvet_goldmine,6.5,38,21,17,55,5.7,5,1,4,20,3.7,10467,80,http://content9.flixster.com/movie/69/65/48/6965487_det.jpg,-25
1392,Citizen Ruth,115906,Citizen Ruth,"http://ia.media-imdb.com/images/M/MV5BMTMyNTEzMTU3MV5BMl5BanBnXkFtZTYwMDgwMzM5._V1._SX214_CR0,0,214,314_.jpg",1996,citizen_ruth,6.8,24,19,5,79,6,5,3,2,60,3.5,998,72,http://content9.flixster.com/movie/10/89/27/10892735_det.jpg,7
42,Dead Presidents,112819,Dinero para quemar,"http://ia.media-imdb.com/images/M/MV5BMzE0NTI0MTM5MV5BMl5BanBnXkFtZTcwMzYwMTYyMQ@@._V1._SX214_CR0,0,214,314_.jpg",1995,dead_presidents,5.7,31,14,17,45,6.3,12,7,5,58,3.3,4475,75,http://content7.flixster.com/movie/26/95/269521_det.jpg,-30
2353,Enemy of the State,120660,Enemigo público,http://ia.media-imdb.com/images/M/MV5BMTI1ODg5NDU3Ml5BMl5BanBnXkFtZTcwOTQ4ODIzMQ@@._V1._SX99_SY140_.jpg,1998,enemy_of_the_state,6.4,81,57,24,70,6.2,20,13,7,65,3.5,34766,76,http://content9.flixster.com/movie/10/87/15/10871599_det.jpg,-6
1003,Extreme Measures,116259,Al cruzar el límite,"http://ia.media-imdb.com/images/M/MV5BMTIyMzI3MDU0NF5BMl5BanBnXkFtZTcwNTYyMjAwMQ@@._V1._SY296_CR1,0,214,296_.jpg",1996,extreme_measures,6,31,17,14,54,5.7,6,2,4,33,2.9,2772,37,http://content7.flixster.com/movie/28/29/282909_det.jpg,17
4861,Mission to Mir,119682,Misión Mir,"http://ia.media-imdb.com/images/M/MV5BMTUyODI2NTgzMF5BMl5BanBnXkFtZTcwNDI2MTQyMQ@@._V1._SX214_CR0,0,214,314_.jpg",1997,mission-to-mir-imax,0,0,0,0,0,0,0,0,0,0,0,0,0,http://content9.flixster.com/movie/10/94/53/10945395_det.jpg,0
6864,Concert for George,380275,Concert for George,"http://ia.media-imdb.com/images/M/MV5BMTYwODMyMTM1NV5BMl5BanBnXkFtZTcwNzEwMTYyMQ@@._V1._SY216_CR34,0,214,216_.jpg",2003,concert_for_george,7.6,18,17,1,94,7.3,9,8,1,88,4.3,31,90,http://content9.flixster.com/movie/11/00/78/11007847_det.jpg,4
2617,The Mummy,120616,The mummy - La momia,"http://ia.media-imdb.com/images/M/MV5BMTg4NDEyNTY2NF5BMl5BanBnXkFtZTcwOTI0NDIyMQ@@._V1._SY314_CR0,0,214,314_.jpg",1999,1087270-mummy,5.7,81,44,37,54,5.1,17,7,10,41,3.4,79634,75,http://content9.flixster.com/movie/55/05/83/5505839_det.jpg,-21
6669,Ikiru,44741,Vivir,"http://ia.media-imdb.com/images/M/MV5BMTcyMDU0MTQzNV5BMl5BanBnXkFtZTcwOTk2NDQyMQ@@._V1._SY314_CR4,0,214,314_.jpg",1952,ikiru,8.6,30,30,0,100,8.3,9,9,0,100,4.5,5818,96,http://content9.flixster.com/movie/11/14/66/11146651_det.jpg,4
8795,Musa,275083,Musa,"http://ia.media-imdb.com/images/M/MV5BNzMxNDE1ODQ4OV5BMl5BanBnXkFtZTcwMzA3MTIzMQ@@._V1._SY314_CR2,0,214,314_.jpg",2001,musa-the-warrior,0,1,1,0,100,0,0,0,0,0,0,0,0,http://content6.flixster.com/movie/10/88/78/10887828_det.jpg,100
5313,The Scorpion King,277296,El rey escorpión,"http://ia.media-imdb.com/images/M/MV5BOTA1NTg0MDcxMF5BMl5BanBnXkFtZTcwNjUzODkyMw@@._V1._SX214_CR0,0,214,314_.jpg",2002,scorpion_king,4.9,130,52,78,40,4.5,27,8,19,29,2.9,30398,53,http://content8.flixster.com/movie/26/12/261218_det.jpg,-13
4728,Rat Race,250687,Ratas a la carrera,"http://ia.media-imdb.com/images/M/MV5BMTkxNDM4ODE4OF5BMl5BanBnXkFtZTcwMjQ5NDcxMQ@@._V1._SY314_CR2,0,214,314_.jpg",2001,rat_race,4.9,124,53,71,42,4.2,28,8,20,28,3.1,23720,63,http://content7.flixster.com/movie/10/88/81/10888109_det.jpg,-21
7013,The Night of the Hunter,48424,La noche del cazador,"http://ia.media-imdb.com/images/M/MV5BOTY2MzI1MzIyMV5BMl5BanBnXkFtZTcwMDI5NTYxMQ@@._V1._SX214_CR0,0,214,314_.jpg",1955,night_of_the_hunter,8.7,41,40,1,97,8,8,7,1,87,4.2,5852,91,http://content7.flixster.com/movie/29/13/291397_det.jpg,6
1632,A Smile Like Yours,120151,Una sonrisa como la tuya,"http://ia.media-imdb.com/images/M/MV5BMjA2NDc4MTc3OF5BMl5BanBnXkFtZTcwMjg3MzQyMQ@@._V1._SY314_CR4,0,214,314_.jpg",1997,the-risk-is-yours,0,0,0,0,0,0,0,0,0,0,0,0,0,http://content9.flixster.com/movie/10/84/78/10847859_det.jpg,0
7365,Nói albínói,351461,Nói albínói,"http://ia.media-imdb.com/images/M/MV5BMTIzNDM5Mzc2Nl5BMl5BanBnXkFtZTcwMTU1MTYyMQ@@._V1._SY216_CR35,0,214,216_.jpg",2003,noi-the-albino,7,53,46,7,86,6.4,15,12,3,80,3.9,1758,85,http://content8.flixster.com/movie/10/92/73/10927342_det.jpg,1
44633,The Devil and Daniel Johnston,436231,The Devil and Daniel Johnston,"http://ia.media-imdb.com/images/M/MV5BMjE0NTk1NzUyN15BMl5BanBnXkFtZTcwMDUyMzIzMQ@@._V1._SX214_CR0,0,214,314_.jpg",2005,1158179-devil_and_daniel_johnston,7.5,105,93,12,88,7.9,28,26,2,92,3.7,11571,74,http://content8.flixster.com/movie/10/89/59/10895946_det.jpg,14
6480,Thoroughly Modern Millie,62362,"Millie, una chica moderna","http://ia.media-imdb.com/images/M/MV5BMTAyMjM1MjA0MTReQTJeQWpwZ15BbWU2MDU4MjI4OQ@@._V1._SX122_CR0,0,122,314_.jpg",1967,thoroughly_modern_millie,7.6,9,9,0,100,0,0,0,0,0,0,0,0,http://content8.flixster.com/movie/25/10/251014_det.jpg,100
45361,An American Haunting,429573,Maleficio,"http://ia.media-imdb.com/images/M/MV5BOTg0MDcyNDczMl5BMl5BanBnXkFtZTcwNjE4ODIzMQ@@._V1._SX214_CR0,0,214,314_.jpg",2005,american_haunting,3.5,68,8,60,11,3.5,15,2,13,13,3,32251,48,http://content8.flixster.com/movie/10/87/72/10877250_det.jpg,-37
1148,Wallace & Gromit in The Wrong Trousers,108598,Wallace & Gromit in The Wrong Trousers,"http://ia.media-imdb.com/images/M/MV5BMTgxNjQxNzM0OV5BMl5BanBnXkFtZTcwMTQyNzAyMQ@@._V1._SX214_CR0,0,214,314_.jpg",1993,wallace_and_gromit_the_wrong_trousers,9.1,24,24,0,100,0,0,0,0,0,0,0,0,http://content9.flixster.com/movie/74/28/86/7428867_det.jpg,100
32617,Sinbad and the Eye of the Tiger,76716,Sinbad y el ojo del tigre,"http://ia.media-imdb.com/images/M/MV5BMTU4NjA4MDQzM15BMl5BanBnXkFtZTcwNDU1NDYyMQ@@._V1._SY305_CR1,0,214,305_.jpg",1977,sinbad_and_the_eye_of_the_tiger,6,8,5,3,62,0,0,0,0,0,0,0,0,http://content7.flixster.com/movie/10/93/16/10931669_det.jpg,62
5465,Riri Shushu no subete,297721,Riri Shushu no subete,"http://ia.media-imdb.com/images/M/MV5BMTQ0NjEyMzkwNl5BMl5BanBnXkFtZTcwMTIxODcyMQ@@._V1._SY314_CR5,0,214,314_.jpg",2001,all_about_lily_chouchou,6.7,37,25,12,67,7.3,11,8,3,72,4.1,2372,88,http://content9.flixster.com/movie/10/86/05/10860555_det.jpg,-21
44911,Magic,77889,Magia,"http://ia.media-imdb.com/images/M/MV5BMTkwMjI4Njk4Nl5BMl5BanBnXkFtZTcwMjI4ODEzMQ@@._V1._SY314_CR2,0,214,314_.jpg",1978,magic,6.8,18,15,3,83,0,2,1,1,50,3.2,1627,56,http://content7.flixster.com/movie/20/48/89/2048893_det.jpg,27
4271,Eureka,243889,Eureka,"http://ia.media-imdb.com/images/M/MV5BMTU3MTg4OTIwOF5BMl5BanBnXkFtZTYwNzUxNzg4._V1._SY314_CR3,0,214,314_.jpg",2000,1107897-eureka,7.2,42,38,4,90,6.8,19,16,3,84,4.1,667,88,http://content7.flixster.com/movie/18/96/61/1896617_det.jpg,2
60137,The Rape of Europa,997088,The Rape of Europa,"http://ia.media-imdb.com/images/M/MV5BMTk0MDYyMzkyNl5BMl5BanBnXkFtZTcwODkxMzU1MQ@@._V1._SX214_CR0,0,214,314_.jpg",2006,deep-crates-2,0,0,0,0,0,0,0,0,0,0,0,0,0,http://content7.flixster.com/movie/10/39/86/10398633_det.jpg,0
406,Federal Hill,109785,Federal Hill,"http://ia.media-imdb.com/images/M/MV5BMTQxOTY4MzMzNF5BMl5BanBnXkFtZTcwMzM4MTMyMQ@@._V1._SX214_CR0,0,214,314_.jpg",1994,federal_hill,6.4,15,12,3,80,6.2,9,6,3,66,3,131,41,http://content7.flixster.com/movie/28/10/281025_det.jpg,39
2690,An Ideal Husband,122541,Un marido ideal,"http://ia.media-imdb.com/images/M/MV5BMTU3MTkyNTQxM15BMl5BanBnXkFtZTcwNDA2NTAyMQ@@._V1._SY314_CR0,0,214,314_.jpg",1999,1091577-ideal_husband,7.4,63,54,9,85,7.4,15,14,1,93,3.4,2877,66,http://content9.flixster.com/movie/25/54/255491_det.jpg,19
2660,The Thing from Another World,44121,El enigma... de otro mundo,"http://ia.media-imdb.com/images/M/MV5BMjA2ODczNDg5M15BMl5BanBnXkFtZTcwNjM4MDAwMQ@@._V1._SY314_CR1,0,214,314_.jpg",1951,1021242-thing,7.7,26,23,3,88,0,2,1,1,50,3.6,2130,71,http://content6.flixster.com/movie/28/58/285828_det.jpg,17
3731,Cutter's Way,82220,El camino de Cutter,"http://ia.media-imdb.com/images/M/MV5BMTc1NDE5OTE1MV5BMl5BanBnXkFtZTcwMzQwMTYyMQ@@._V1._SX214_CR0,0,214,314_.jpg",1981,cutters_way,7.3,5,5,0,100,0,0,0,0,0,0,0,0,http://content9.flixster.com/movie/27/99/279923_det.jpg,100
4321,City Slickers,101587,Cowboys de ciudad,"http://ia.media-imdb.com/images/M/MV5BMTQxNDMzNjg0MF5BMl5BanBnXkFtZTcwNDYxMzAyMQ@@._V1._SX214_CR0,0,214,314_.jpg",1991,city_slickers,6.7,26,23,3,88,0,2,2,0,100,3.1,7371,59,http://content6.flixster.com/movie/11/15/27/11152780_det.jpg,29
8765,This Gun for Hire,35432,Contratado para matar,"http://ia.media-imdb.com/images/M/MV5BMTc3OTgwOTI0N15BMl5BanBnXkFtZTcwNzk4ODUyMQ@@._V1._SY314_CR3,0,214,314_.jpg",1942,1021269-this_gun_for_hire,7.3,13,12,1,92,0,1,1,0,100,3.7,648,80,http://content9.flixster.com/movie/29/30/293091_det.jpg,12
4954,Ocean's Eleven,240772,Ocean's eleven. Hagan juego,"http://ia.media-imdb.com/images/M/MV5BMTgwMTQ5NzEzN15BMl5BanBnXkFtZTYwNjU5NjA5._V1._SX214_CR0,0,214,314_.jpg",2001,oceans_eleven,6.9,166,135,31,81,7.2,33,28,5,84,3.6,185259,76,http://content6.flixster.com/movie/11/15/10/11151032_det.jpg,5
2847,Only Angels Have Wings,31762,Sólo los ángeles tienen alas,"http://ia.media-imdb.com/images/M/MV5BMTMyMjk5MTQ2MF5BMl5BanBnXkFtZTcwMDU4MjgxMQ@@._V1._SY314_CR4,0,214,314_.jpg",1939,only_angels_have_wings,8.4,11,11,0,100,0,1,1,0,100,3.8,1509,78,http://content7.flixster.com/movie/29/52/295293_det.jpg,22
8836,Wicker Park,324554,Obsesión - Wicker Park,"http://ia.media-imdb.com/images/M/MV5BMTkxNjgzMzI4MV5BMl5BanBnXkFtZTcwMzA3MjcyMQ@@._V1._SY314_CR8,0,214,314_.jpg",2004,wicker_park,4.3,120,28,92,23,4.3,30,7,23,23,3.5,12752,79,http://content8.flixster.com/movie/10/84/98/10849878_det.jpg,-56
33826,Saint Ralph,384488,Saint Ralph,"http://ia.media-imdb.com/images/M/MV5BMjA3MDk0NDgxOV5BMl5BanBnXkFtZTYwOTQyNjAz._V1._CR78,0,293,293_SS120_.jpg",2004,10005178-saint_ralph,6.3,67,42,25,62,6.1,24,15,9,62,3.8,1289,83,http://content7.flixster.com/movie/10/86/87/10868781_det.jpg,-21
7219,They Drive by Night,33149,La pasión ciega,"http://ia.media-imdb.com/images/M/MV5BMTQwNDA3MzMzMV5BMl5BanBnXkFtZTcwMjQ4NDAwMQ@@._V1._SY314_CR3,0,214,314_.jpg",1940,1021214-they_drive_by_night,6.8,17,16,1,94,0,0,0,0,0,0,0,0,http://content6.flixster.com/movie/11/12/46/11124664_det.jpg,94
6928,"Die, Mommie, Die!",322023,"Die, Mommie, Die!","http://ia.media-imdb.com/images/M/MV5BMTI5MzIxNDg2NV5BMl5BanBnXkFtZTcwNzk5MTQyMQ@@._V1._SY314_CR0,0,214,314_.jpg",2003,die_mommie_die,6,59,38,21,64,6.5,21,16,5,76,3.5,839,67,http://content6.flixster.com/movie/10/87/89/10878936_det.jpg,-3
1811,Niagara,46126,Niágara,"http://ia.media-imdb.com/images/M/MV5BMjA5NjM4Mjg4OF5BMl5BanBnXkFtZTcwNTIwNzkzMQ@@._V1._SY314_CR3,0,214,314_.jpg",1953,niagara,6.2,10,8,2,80,0,0,0,0,0,0,0,0,http://content6.flixster.com/movie/10/85/38/10853848_det.jpg,80
5970,My Girl,102492,Mi chica,"http://ia.media-imdb.com/images/M/MV5BMTkwNjA5MzQ2OV5BMl5BanBnXkFtZTcwMjAxMDYyMQ@@._V1._SY314_CR4,0,214,314_.jpg",1991,1037649-my_girl,5.3,12,6,6,50,0,2,1,1,50,3.5,29984,75,http://content6.flixster.com/movie/26/11/261104_det.jpg,-25
3007,American Movie,181288,American Movie,"http://ia.media-imdb.com/images/M/MV5BOTA1OTEzMjM4MV5BMl5BanBnXkFtZTcwOTgwNDcxMQ@@._V1._SX214_CR0,0,214,314_.jpg",1999,american_movie,8.3,46,43,3,93,8.9,7,7,0,100,4,3544,87,http://content6.flixster.com/movie/27/00/270020_det.jpg,6
7934,Zelig,86637,Zelig,"http://ia.media-imdb.com/images/M/MV5BMTk2NTU3Njg4NF5BMl5BanBnXkFtZTcwNjQyNzMyMQ@@._V1._SY314_CR3,0,214,314_.jpg",1983,zelig,7.7,17,17,0,100,0,0,0,0,0,0,0,0,http://content9.flixster.com/movie/25/82/258299_det.jpg,100
8581,Pirates of Silicon Valley,168122,Piratas de Silicon Valey,"http://ia.media-imdb.com/images/M/MV5BMTU1NTE3MjAwNF5BMl5BanBnXkFtZTcwNjEyOTkyMQ@@._V1._SY314_CR23,0,214,314_.jpg",1999,pirates_of_silicon_valley,6.8,7,6,1,85,0,0,0,0,0,0,0,0,http://content9.flixster.com/movie/10/90/59/10905935_det.jpg,85
36519,Transporter 2,388482,Transporter 2,"http://ia.media-imdb.com/images/M/MV5BMTQ5MDM0MTI2N15BMl5BanBnXkFtZTcwNTM5NDczMw@@._V1._SX214_CR0,0,214,314_.jpg",2005,62,0,0,0,0,0,0,0,0,0,0,0,0,0,http://content8.flixster.com/movie/10/84/50/10845022_det.jpg,0
1135,Private Benjamin,81375,La recluta Benjamín,"http://ia.media-imdb.com/images/M/MV5BMTQyMTU5MTYwOF5BMl5BanBnXkFtZTcwNzIyMjkxMQ@@._V1._SY314_CR8,0,214,314_.jpg",1980,private_benjamin,6.7,22,19,3,86,0,1,1,0,100,3,3377,57,http://content6.flixster.com/movie/27/50/275008_det.jpg,29
34150,Fantastic Four,120667,Los cuatro fantásticos,"http://ia.media-imdb.com/images/M/MV5BMTU2NDk4MzExNl5BMl5BanBnXkFtZTcwNjkzMTIzMQ@@._V1._SY314_CR5,0,214,314_.jpg",2005,fantastic_four,4.5,200,54,146,27,4.7,34,10,24,29,3.2,95962,57,http://content8.flixster.com/movie/10/90/66/10906682_det.jpg,-30
4745,O,184791,Laberinto envenenado,"http://ia.media-imdb.com/images/M/MV5BMTY2ODI4NDk3Nl5BMl5BanBnXkFtZTcwMzcwODcxMQ@@._V1._SY314_CR4,0,214,314_.jpg",2001,o,6,123,78,45,63,5.2,31,16,15,51,3,4986,58,http://content9.flixster.com/movie/32/93/10/3293107_det.jpg,5
51662,300,416449,300,"http://ia.media-imdb.com/images/M/MV5BMjAzNTkzNjcxNl5BMl5BanBnXkFtZTYwNDA4NjE3._V1._SX214_CR0,0,214,314_.jpg",2006,300,6.1,223,133,90,59,5.6,41,19,22,46,4.1,476879,90,http://content7.flixster.com/movie/28/60/90/2860905_det.jpg,-31
3853,The Tic Code,165986,The Tic Code,"http://ia.media-imdb.com/images/M/MV5BMTMwNzEwNjMzM15BMl5BanBnXkFtZTcwMzk2NTkxMQ@@._V1._SY314_CR3,0,214,314_.jpg",1999,the-tic-code,6.6,28,21,7,75,7.2,11,10,1,90,3.5,135,64,http://content7.flixster.com/movie/10/88/66/10886661_det.jpg,11
6009,Hyôryû-gai,246498,Hyôryû-gai,"http://ia.media-imdb.com/images/M/MV5BMzk4NDEyODcxOV5BMl5BanBnXkFtZTcwMjg1MTAzMQ@@._V1._SY314_CR11,0,214,314_.jpg",2000,1110769-city_of_lost_souls,5.4,12,7,5,58,0,2,1,1,50,3.2,791,48,http://content9.flixster.com/movie/10/92/43/10924339_det.jpg,10
7221,Platinum Blonde,22268,La jaula de oro,"http://ia.media-imdb.com/images/M/MV5BMTI2MDc4MDQ3MF5BMl5BanBnXkFtZTcwODM1NTQyMQ@@._V1._SY314_CR2,0,214,314_.jpg",1931,1038237-platinum_blonde,7.2,6,6,0,100,0,0,0,0,0,0,0,0,http://content6.flixster.com/movie/30/35/303596_det.jpg,100
2963,Joe the King,160672,Joe the King,http://ia.media-imdb.com/images/M/MV5BMTMzMTQwNzEyN15BMl5BanBnXkFtZTcwOTI2MzUxMQ@@._V1._SX96_SY140_.jpg,1999,joe_the_king,6,24,15,9,62,5.8,5,1,4,20,3.5,396,67,http://content7.flixster.com/movie/27/87/278717_det.jpg,-5
5169,Scarlet Street,38057,Perversidad,"http://ia.media-imdb.com/images/M/MV5BMTk0NTkyOTU4NF5BMl5BanBnXkFtZTcwNzU4MDMzMQ@@._V1._SY314_CR3,0,214,314_.jpg",1945,scarlet_street,8,11,11,0,100,0,0,0,0,0,0,0,0,http://content9.flixster.com/movie/29/87/298707_det.jpg,100
8973,La mala educación,275491,La mala educación,"http://ia.media-imdb.com/images/M/MV5BNjQ2NDgyNzMzOV5BMl5BanBnXkFtZTcwNDY0OTUyMQ@@._V1._SY314_CR2,0,214,314_.jpg",2004,bad_education,7.5,134,118,16,88,7.8,35,30,5,85,3.9,13423,85,http://content8.flixster.com/movie/10/88/78/10887886_det.jpg,3
31047,Jinxed!,84173,Blackjack,"http://ia.media-imdb.com/images/M/MV5BMTIwMjk2NjMxOF5BMl5BanBnXkFtZTcwNjkzMTcyMQ@@._V1._SY314_CR8,0,214,314_.jpg",1982,jinxed,0,1,0,1,0,0,0,0,0,0,0,0,0,http://content9.flixster.com/movie/10/86/60/10866067_det.jpg,0
52281,Grindhouse,462322,Grindhouse,"http://ia.media-imdb.com/images/M/MV5BMjA0MzExNzc3MV5BMl5BanBnXkFtZTcwODAxMzM0MQ@@._V1._SX214_CR0,0,214,314_.jpg",2007,grindhouse,7.4,188,155,33,82,7.1,40,31,9,77,3.9,98721,86,http://content6.flixster.com/movie/52/53/62/5253624_det.jpg,-4
4572,Black Rain,96933,Black Rain,"http://ia.media-imdb.com/images/M/MV5BMTg4MTEwNjYzNF5BMl5BanBnXkFtZTcwNDk4OTUzMQ@@._V1._SY314_CR3,0,214,314_.jpg",1989,1002512-black_rain,5.4,21,12,9,57,0,1,0,1,0,0,0,0,http://content7.flixster.com/movie/20/77/72/2077725_det.jpg,57
60735,Shotgun Stories,952682,Shotgun Stories,"http://ia.media-imdb.com/images/M/MV5BMTU0OTgzMTYyM15BMl5BanBnXkFtZTcwMjk1OTI0MQ@@._V1._SY314_CR2,0,214,314_.jpg",2007,shotgun_stories,7.3,40,37,3,92,7.1,10,9,1,90,3.8,1261,79,http://content6.flixster.com/movie/10/93/54/10935476_det.jpg,13
18,Four Rooms,113101,Four Rooms,"http://ia.media-imdb.com/images/M/MV5BMTcwOTMzODQ5MV5BMl5BanBnXkFtZTcwNjgyMjAwMQ@@._V1._SX214_CR0,0,214,314_.jpg",1995,four_rooms,3.5,42,6,36,14,2.9,11,0,11,0,3.5,14266,72,http://content7.flixster.com/movie/93/49/77/9349773_det.jpg,-58
8661,How the West Was Won,56085,La conquista del Oeste,"http://ia.media-imdb.com/images/M/MV5BMjAwMzA2MTExNV5BMl5BanBnXkFtZTcwMDEwODc0MQ@@._V1._SY314_CR3,0,214,314_.jpg",1962,how_the_west_was_won,7.1,15,14,1,93,0,0,0,0,0,0,0,0,http://content7.flixster.com/movie/10/93/43/10934329_det.jpg,93
34148,De battre mon coeur s'est arrêté,411270,"De latir, mi corazón se ha parado","http://ia.media-imdb.com/images/M/MV5BMjA5NzM5OTcxMF5BMl5BanBnXkFtZTcwMTExMjAzMQ@@._V1._SX214_CR0,0,214,314_.jpg",2005,beat_that_my_heart_skipped,7.2,91,77,14,84,6.9,28,22,6,78,3.9,3473,83,http://content9.flixster.com/movie/18/93/97/1893979_det.jpg,1
5149,Cattle Queen of Montana,46839,La reina de Montana,"http://ia.media-imdb.com/images/M/MV5BMTcyMzE4MDI4OV5BMl5BanBnXkFtZTcwNjIwODAwMQ@@._V1._SY314_CR3,0,214,314_.jpg",1954,cattle_queen_of_montana,0,1,1,0,100,0,0,0,0,0,0,0,0,http://content9.flixster.com/movie/10/85/30/10853007_det.jpg,100
46919,End of the Spear,399862,El final del espíritu,"http://ia.media-imdb.com/images/M/MV5BMTYxOTU0NDUzMV5BMl5BanBnXkFtZTcwNDgzMTczMQ@@._V1._SX214_CR0,0,214,314_.jpg",2005,end_of_the_spear,5.1,51,20,31,39,4.3,17,3,14,17,3.7,2835,82,http://content6.flixster.com/movie/10/87/81/10878116_det.jpg,-43
4941,Flash Gordon,80745,Flash Gordon,"http://ia.media-imdb.com/images/M/MV5BMTMzNDA3OTQwOF5BMl5BanBnXkFtZTcwNzU0MzM1MQ@@._V1._SY314_CR9,0,214,314_.jpg",1980,1007517-flash_gordon,6.3,32,26,6,81,0,3,2,1,66,3.1,6492,64,http://content7.flixster.com/movie/25/73/257321_det.jpg,17
3217,A Star Is Born,29606,Ha nacido una estrella,"http://ia.media-imdb.com/images/M/MV5BMjAxNTQzMDU5OV5BMl5BanBnXkFtZTcwOTkyMzcyMQ@@._V1._SY314_CR8,0,214,314_.jpg",1937,1019828-star_is_born,7.3,11,11,0,100,0,0,0,0,0,0,0,0,http://content7.flixster.com/movie/10/88/77/10887749_det.jpg,100
4787,Little Man Tate,102316,El pequeño Tate,"http://ia.media-imdb.com/images/M/MV5BMTMyODM5MzI5OF5BMl5BanBnXkFtZTcwOTg2MzkxMQ@@._V1._SY314_CR1,0,214,314_.jpg",1991,little_man_tate,6.2,23,18,5,78,0,2,1,1,50,3.2,2824,62,http://content6.flixster.com/movie/10/91/68/10916848_det.jpg,16
5551,The Return of the Vampire,37219,The Return of the Vampire,"http://ia.media-imdb.com/images/M/MV5BMTU0OTQ5MjAwMV5BMl5BanBnXkFtZTcwNDI1MDYxMQ@@._V1._SY314_CR0,0,214,314_.jpg",1944,return_of_the_vampire,5.3,5,3,2,60,0,0,0,0,0,0,0,0,http://content7.flixster.com/movie/10/85/82/10858249_det.jpg,60
6937,Anything But Love,96534,Anything But Love,"http://ia.media-imdb.com/images/M/MV5BMTUxNzA0MTQwNl5BMl5BanBnXkFtZTcwNjM1MDE0MQ@@._V1._SY314_CR11,0,214,314_.jpg",1989,anything-but-love,0,0,0,0,0,0,0,0,0,0,0,0,0,http://content6.flixster.com/movie/10/84/28/10842848_det.jpg,0
8889,The Legacy,79450,El legado,"http://ia.media-imdb.com/images/M/MV5BMTYyMzU1NTYxMF5BMl5BanBnXkFtZTcwNjY2MzYyMQ@@._V1._SY314_CR3,0,214,314_.jpg",1978,1012162-legacy,0,1,1,0,100,0,0,0,0,0,0,0,0,http://content8.flixster.com/movie/10/91/41/10914170_det.jpg,100
4734,Jay and Silent Bob Strike Back,261392,Jay y Bob el Silencioso contraatacan,"http://ia.media-imdb.com/images/M/MV5BMTIwNTMxMjA2Ml5BMl5BanBnXkFtZTcwNTIyNTEzMQ@@._V1._SY314_CR3,0,214,314_.jpg",2001,jay_and_silent_bob_strike_back,5.6,148,78,70,52,5.3,31,14,17,45,3.4,44787,77,http://content9.flixster.com/movie/10/93/56/10935619_det.jpg,-25
1073,Willy Wonka & the Chocolate Factory,67992,Un mundo de fantasía,"http://ia.media-imdb.com/images/M/MV5BMTM4OTQ3NjA5N15BMl5BanBnXkFtZTcwMTc5NjIyMQ@@._V1._SY314_CR9,0,214,314_.jpg",1971,willy_wonka_and_the_chocolate_factory,7.5,29,26,3,89,0,0,0,0,0,0,0,0,http://content9.flixster.com/movie/25/32/253203_det.jpg,89
6144,La traviata,84821,La traviata,"http://ia.media-imdb.com/images/M/MV5BMTU4ODgzNzE2NV5BMl5BanBnXkFtZTYwMDUwMTk5._V1._SX188_CR0,0,188,314_.jpg",1982,traviata-la,0,0,0,0,0,0,0,0,0,0,0,0,0,http://content8.flixster.com/movie/10/93/16/10931694_det.jpg,0
3536,Keeping the Faith,171433,Más que amigos,"http://ia.media-imdb.com/images/M/MV5BMTQ4MTgwOTU4M15BMl5BanBnXkFtZTcwOTUxMjEzMQ@@._V1._SX214_CR0,0,214,314_.jpg",2000,keeping_the_faith,6.2,114,78,36,68,5.8,25,14,11,56,3,9636,55,http://content8.flixster.com/movie/25/69/256998_det.jpg,13
3339,Cross of Iron,74695,La cruz de Hierro,"http://ia.media-imdb.com/images/M/MV5BMTU2MzI4OTI0OF5BMl5BanBnXkFtZTcwODExMzIzMQ@@._V1._SY314_CR3,0,214,314_.jpg",1977,cross_of_iron,6.3,14,11,3,78,0,1,0,1,0,0,0,0,http://content6.flixster.com/movie/10/87/31/10873144_det.jpg,78
2908,Boys Don't Cry,171804,Boys Don't Cry,"http://ia.media-imdb.com/images/M/MV5BMTIxMjk0NjE1NV5BMl5BanBnXkFtZTYwMTU3MTc4._V1._SX214_CR0,0,214,314_.jpg",1999,boys_dont_cry,7.9,73,64,9,87,7.9,22,19,3,86,3.7,16491,85,http://content8.flixster.com/movie/10/89/13/10891334_det.jpg,2
43987,Half Light,412798,En la tiniebla,"http://ia.media-imdb.com/images/M/MV5BMTYzMjg4NzA2MF5BMl5BanBnXkFtZTcwMzAyNjUzMQ@@._V1._SX214_CR0,0,214,314_.jpg",2006,half-light,4.1,7,2,5,28,0,0,0,0,0,0,0,0,http://content9.flixster.com/movie/10/91/82/10918207_det.jpg,28
596,Pinocchio,32910,Pinocho,"http://ia.media-imdb.com/images/M/MV5BMTI1NDM4ODQ3Ml5BMl5BanBnXkFtZTcwNzE1MzQyMQ@@._V1._SY314_CR1,0,214,314_.jpg",1940,1016342-pinocchio,9,37,37,0,100,8.5,5,5,0,100,3.3,19102,66,http://content8.flixster.com/movie/10/87/27/10872762_det.jpg,34
1153,Raw Deal,91828,Ejecutor,"http://ia.media-imdb.com/images/M/MV5BNjYwNjY4MTQzN15BMl5BanBnXkFtZTcwOTM4OTQyMQ@@._V1._SY314_CR3,0,214,314_.jpg",1986,1017226-raw_deal,3.8,12,3,9,25,0,1,0,1,0,2.7,3041,32,http://content7.flixster.com/movie/10/87/80/10878017_det.jpg,-7
5173,Divorcing Jack,127516,Divorcing Jack,"http://ia.media-imdb.com/images/M/MV5BMTg3MTk2MjE4M15BMl5BanBnXkFtZTcwOTA1OTEyMQ@@._V1._SY314_CR3,0,214,314_.jpg",1998,divorcing-jack,0,0,0,0,0,0,0,0,0,0,0,0,0,http://content8.flixster.com/movie/34/83/18/3483186_det.jpg,0
62049,Nineteen Eighty-Four,87803,1984,"http://ia.media-imdb.com/images/M/MV5BMTcxMDA4MjQ4M15BMl5BanBnXkFtZTcwNTUxOTY5Mw@@._V1._SX214_CR0,0,214,314_.jpg",1984,1000055-1984,6.4,14,11,3,78,0,1,1,0,100,3.5,17133,70,http://content7.flixster.com/movie/10/88/05/10880581_det.jpg,8
6737,Super Sucker,293624,Super Sucker,"http://ia.media-imdb.com/images/M/MV5BMTkwNDk5MTY5OF5BMl5BanBnXkFtZTcwOTI1NjYzMQ@@._V1._SY314_CR17,0,214,314_.jpg",2002,super_sucker,4.1,14,4,10,28,0,4,1,3,25,2.9,303,42,http://content6.flixster.com/movie/27/95/279504_det.jpg,-14
2170,Wrongfully Accused,120901,¡Vaya un fugitivo!,"http://ia.media-imdb.com/images/M/MV5BMjEyNDgwODgzOF5BMl5BanBnXkFtZTcwMzcyMzYxMQ@@._V1._SX214_CR0,0,214,314_.jpg",1998,wrongfully_accused,3.8,31,7,24,22,2.9,6,0,6,0,2.8,2483,56,http://content9.flixster.com/movie/10/92/01/10920195_det.jpg,-34
8671,Zus & zo,245157,Zus & zo,"http://ia.media-imdb.com/images/M/MV5BMTIxMjQxMzExNl5BMl5BanBnXkFtZTcwMDAyMTcxMQ@@._V1._SY314_CR3,0,214,314_.jpg",2001,zus-zo-hotel-paraiso,4.9,19,8,11,42,4,9,1,8,11,3,136,41,http://content6.flixster.com/movie/10/87/04/10870492_det.jpg,1
6201,Lady Jane,91374,Lady Jane,"http://ia.media-imdb.com/images/M/MV5BMTg0NDg4NTc2Nl5BMl5BanBnXkFtZTcwMjcxMjIyMQ@@._V1._SY314_CR4,0,214,314_.jpg",1986,lady_jane,5.4,7,4,3,57,0,0,0,0,0,0,0,0,http://content7.flixster.com/movie/10/86/75/10867517_det.jpg,57
6539,Pirates of the Caribbean: The Curse of the Black Pearl,325980,Piratas del Caribe - La maldición de la Perla Negra,"http://ia.media-imdb.com/images/M/MV5BMjAyNDM4MTc2N15BMl5BanBnXkFtZTYwNDk0Mjc3._V1._SX214_CR0,0,214,314_.jpg",2003,pirates_of_the_caribbean_the_curse_of_the_black_pearl,7.1,196,153,43,78,6.4,38,25,13,65,3.9,297546,86,http://content6.flixster.com/movie/10/87/11/10871100_det.jpg,-8
3634,Seven Days in May,58576,Siete días de mayo,"http://ia.media-imdb.com/images/M/MV5BMTg2NzI4MDI2NV5BMl5BanBnXkFtZTYwMTAxNzc5._V1._SY314_CR7,0,214,314_.jpg",1964,seven_days_in_may,7.8,18,18,0,100,0,3,3,0,100,3.9,754,86,http://content6.flixster.com/movie/10/87/45/10874540_det.jpg,14
8826,Ressources humaines,220726,Recursos humanos,"http://ia.media-imdb.com/images/M/MV5BMTY4MTE4NzYxOF5BMl5BanBnXkFtZTYwMDgwMzg5._V1._SX214_CR0,0,214,314_.jpg",1999,human_resources,7.8,31,30,1,96,7.8,7,7,0,100,3.7,375,77,http://content9.flixster.com/movie/31/05/310523_det.jpg,19
31588,Casque d'or,43386,"París, bajos fondos","http://ia.media-imdb.com/images/M/MV5BOTY2Njk2MTI0NV5BMl5BanBnXkFtZTcwODc1NTcyMQ@@._V1._SY314_CR3,0,214,314_.jpg",1952,casque_dor,8.4,11,11,0,100,0,3,3,0,100,3.7,397,76,http://content7.flixster.com/movie/10/86/74/10867413_det.jpg,24
8840,I Call First,63803,¿Quién llama a mi puerta?,"http://ia.media-imdb.com/images/M/MV5BMTUxNTAzOTIyMl5BMl5BanBnXkFtZTcwNjgzOTUyMQ@@._V1._SY314_CR18,0,214,314_.jpg",1967,whos_that_knocking_at_my_door,6.1,13,9,4,69,0,4,1,3,25,3.4,1323,61,http://content7.flixster.com/movie/10/86/70/10867009_det.jpg,8
1323,Amityville 3-D,85159,El pozo del infierno,"http://ia.media-imdb.com/images/M/MV5BMjAzNjYyNjU2OV5BMl5BanBnXkFtZTcwNzU2NzgyMQ@@._V1._SY314_CR8,0,214,314_.jpg",1983,amityville_3d,2.9,15,0,15,0,0,2,0,2,0,2.7,2070,32,http://content7.flixster.com/movie/26/28/262801_det.jpg,-32
44613,Take the Lead,446046,Déjate llevar,"http://ia.media-imdb.com/images/M/MV5BMTQ3MzM5MjY0MV5BMl5BanBnXkFtZTcwOTIyNjQzMQ@@._V1._SX214_CR0,0,214,314_.jpg",2006,take_the_lead,5.4,119,52,67,43,5.2,31,12,19,38,3.5,92007,78,http://content9.flixster.com/movie/10/87/38/10873803_det.jpg,-35
7340,Just One of the Guys,89393,Un chico como todos,"http://ia.media-imdb.com/images/M/MV5BMTI4Mjc3NDQ1N15BMl5BanBnXkFtZTcwNjkyMDUyMQ@@._V1._SY314_CR0,0,214,314_.jpg",1985,just_one_of_the_guys,4.6,10,4,6,40,0,2,0,2,0,3.3,2022,66,http://content9.flixster.com/movie/10/83/87/10838715_det.jpg,-26
26038,Teacher's Pet,350194,Teacher's Pet,http://ia.media-imdb.com/images/M/MV5BMTgxNzM1OTg1NV5BMl5BanBnXkFtZTcwODYwNTQyMQ@@._V1._SX134_SY199_.jpg,2004,1129129-teachers_pet,6.5,72,54,18,75,6.7,25,19,6,76,2.8,370,38,http://content6.flixster.com/movie/41/61/80/4161808_det.jpg,37
7252,The Three Stooges in Orbit,56580,The Three Stooges in Orbit,"http://ia.media-imdb.com/images/M/MV5BMTkzMjM4Mjg3Ml5BMl5BanBnXkFtZTcwOTE3MzQyMQ@@._V1._SY314_CR2,0,214,314_.jpg",1962,three_stooges_three_stooges_in_orbit,0,0,0,0,0,0,0,0,0,0,0,0,0,http://content6.flixster.com/movie/43/86/09/4386092_det.jpg,0
839,The Crow: City of Angels,115986,El cuervo: ciudad de ángeles,"http://ia.media-imdb.com/images/M/MV5BNDgyMzgxMTE1Ml5BMl5BanBnXkFtZTcwNzMwMTYyMQ@@._V1._SX214_CR0,0,214,314_.jpg",1996,crow_the_city_of_angels,3.4,33,4,29,12,3.3,8,1,7,12,3,12460,51,http://content6.flixster.com/movie/10/93/21/10932152_det.jpg,-39
61240,Låt den rätte komma in,1139797,Déjame entrar,"http://ia.media-imdb.com/images/M/MV5BMjE1OTY2MTM5MF5BMl5BanBnXkFtZTcwNzQ5Mjc5MQ@@._V1._SX214_CR0,0,214,314_.jpg",2008,lat_den_ratte_komma_in,8.2,158,154,4,97,7.9,30,29,1,96,4.2,25695,89,http://content9.flixster.com/movie/10/92/37/10923703_det.jpg,8
61967,Sanma no aji,56444,El gusto del saké,"http://ia.media-imdb.com/images/M/MV5BMTkxNTMxMzQzMl5BMl5BanBnXkFtZTcwNDYwODM5MQ@@._V1._SY314_CR4,0,214,314_.jpg",1962,sanma-no-aji-an-autumn-afternoon-the-widower,7.8,11,10,1,90,0,3,2,1,66,4.2,448,89,http://content7.flixster.com/movie/54/85/78/5485789_det.jpg,1
2440,Another Day in Paradise,127722,Al final del edén,"http://ia.media-imdb.com/images/M/MV5BMTYwMjA1MTU5OF5BMl5BanBnXkFtZTcwMTA0MTQyMQ@@._V1._SY287_CR1,0,214,287_.jpg",1998,1084699-another_day_in_paradise,5.7,46,26,20,56,6.1,12,7,5,58,3.2,1703,57,http://content8.flixster.com/movie/28/72/287214_det.jpg,-1
32076,"Gojira, Ebirâ, Mosura: Nankai no daiketto",60464,"Gojira, Ebirâ, Mosura: Nankai no daiketto",http://ia.media-imdb.com/images/M/MV5BMTQzMzc4MTMzOF5BMl5BanBnXkFtZTYwMjYyMjg5._V1._SX150_SY226_.jpg,1966,godzilla_vs_the_sea_monster,0,2,1,1,50,0,0,0,0,0,0,0,0,http://content8.flixster.com/movie/55/84/23/5584238_det.jpg,50
5781,Private Lessons,82948,La primera lección,http://ia.media-imdb.com/images/M/MV5BMTIyOTg3NDAzMl5BMl5BanBnXkFtZTcwNjU4NDQzMQ@@._V1._SX200_SY286_.jpg,1981,1016793-private_lessons,2.7,6,0,6,0,0,1,0,1,0,2.9,1236,38,http://content8.flixster.com/movie/86/22/74/8622742_det.jpg,-38
896,Les roseaux sauvages,111019,Los juncos salvajes,"http://ia.media-imdb.com/images/M/MV5BNjY1MzY2NDM1Ml5BMl5BanBnXkFtZTcwMTA5MTYyMQ@@._V1._SY314_CR0,0,214,314_.jpg",1994,wild_reeds,8.2,10,10,0,100,0,3,3,0,100,4,604,86,http://content8.flixster.com/movie/11/12/23/11122346_det.jpg,14
1187,Passion Fish,105107,Passion Fish,"http://ia.media-imdb.com/images/M/MV5BMTc5NDc0MDI3Ml5BMl5BanBnXkFtZTcwNzIwOTIyMQ@@._V1._SX214_CR0,0,214,314_.jpg",1992,passion_fish,7.8,22,22,0,100,0,3,3,0,100,3.6,614,79,http://content6.flixster.com/movie/27/83/278392_det.jpg,21
1820,The Proposition,421238,The Proposition,"http://ia.media-imdb.com/images/M/MV5BMTAxNzkwODEwODReQTJeQWpwZ15BbWU3MDIyMjI1MzE@._V1._SY314_CR3,0,214,314_.jpg",2005,proposition,7.3,123,107,16,86,7.4,31,27,4,87,3.6,20228,77,http://content6.flixster.com/movie/31/42/314204_det.jpg,9
5741,La femme d'à côté,82370,La mujer de al lado,"http://ia.media-imdb.com/images/M/MV5BNTA0MDU4ODEwMl5BMl5BanBnXkFtZTcwODQyMjcyMQ@@._V1._SY314_CR2,0,214,314_.jpg",1981,woman_next_door,7.7,10,9,1,90,0,3,3,0,100,3.8,931,80,http://content9.flixster.com/movie/10/92/15/10921579_det.jpg,10
5569,The Last House on the Left,844708,La última casa a la izquierda,"http://ia.media-imdb.com/images/M/MV5BMjExMTM4MDAwOF5BMl5BanBnXkFtZTcwODcyMDIzMg@@._V1._SX214_CR0,0,214,314_.jpg",2009,1205377-last_house_on_the_left,4.9,143,60,83,41,4.5,29,12,17,41,2.7,137767,55,http://content6.flixster.com/movie/10/89/43/10894312_det.jpg,-14
1223,A Grand Day Out with Wallace and Gromit,104361,Wallace & Gromit - La gran excursión,"http://ia.media-imdb.com/images/M/MV5BMTg2ODgyNDY1Ml5BMl5BanBnXkFtZTcwMDY3ODMyMQ@@._V1._SX214_CR0,0,214,314_.jpg",1989,wallace_and_gromit_a_grand_day_out,8.3,19,19,0,100,0,0,0,0,0,0,0,0,http://content8.flixster.com/movie/74/28/88/7428882_det.jpg,100
5868,Elvis,79103,Elvis,"http://ia.media-imdb.com/images/M/MV5BMTQ4MDIxOTk5MF5BMl5BanBnXkFtZTYwNzk4ODM1._V1._SX32_CR0,0,32,44_.jpg",1979,elvis_the_movie,0,2,1,1,50,0,0,0,0,0,0,0,0,http://content7.flixster.com/movie/10/05/52/10055261_det.jpg,50
2226,The Ring,298130,La señal,"http://ia.media-imdb.com/images/M/MV5BNDA2NTg2NjE4Ml5BMl5BanBnXkFtZTYwMjYxMDg5._V1._SX214_CR0,0,214,314_.jpg",2002,ring,6.6,169,120,49,71,6.3,32,18,14,56,3,146246,50,http://content8.flixster.com/movie/10/86/94/10869458_det.jpg,21
4523,The Milagro Beanfield War,95638,Un lugar llamado Milagro,"http://ia.media-imdb.com/images/M/MV5BMTk0NDQ1NTkxOF5BMl5BanBnXkFtZTcwMTIzNTgyMQ@@._V1._SY314_CR3,0,214,314_.jpg",1988,milagro_beanfield_war,5.9,27,16,11,59,5.9,6,3,3,50,3.6,855,72,http://content7.flixster.com/movie/26/74/267493_det.jpg,-13
8092,Frankenstein Unbound,99612,La resurrección de Frankenstein,"http://ia.media-imdb.com/images/M/MV5BMjA5ODc3MTI4M15BMl5BanBnXkFtZTcwMzQxMzUzMQ@@._V1._SX214_CR0,0,214,314_.jpg",1990,frankenstein_unbound,5,15,6,9,40,0,1,1,0,100,2.9,443,37,http://content6.flixster.com/movie/10/83/99/10839980_det.jpg,3
56757,Sweeney Todd: The Demon Barber of Fleet Street,408236,Sweeney Todd - El barbero diabólico de la calle Fleet,"http://ia.media-imdb.com/images/M/MV5BMTg3NjUxMzM5NV5BMl5BanBnXkFtZTcwMzQ1NjQzMw@@._V1._SX214_CR0,0,214,314_.jpg",2007,1183955-1183955-sweeney_todd_the_demon_barber_of_fleet_street,7.6,215,184,31,85,7.5,38,32,6,84,3.9,1391688,81,http://content7.flixster.com/movie/11/12/52/11125277_det.jpg,4
31485,Léon,110413,El profesional (Léon),"http://ia.media-imdb.com/images/M/MV5BMTg5OTI0OTcyM15BMl5BanBnXkFtZTcwODQ0NDcyMQ@@._V1._SY314_CR5,0,214,314_.jpg",1994,professional,6.8,39,30,9,76,5.8,8,4,4,50,4.1,59011,94,http://content7.flixster.com/movie/28/62/286221_det.jpg,-18
1136,Monty Python and the Holy Grail,71853,Los caballeros de la mesa cuadrada y sus locos seguidores,"http://ia.media-imdb.com/images/M/MV5BMTkzODczMTgwM15BMl5BanBnXkFtZTYwNTAwODI5._V1._SX214_CR0,0,214,314_.jpg",1975,monty_python_and_the_holy_grail,7.8,51,48,3,94,7.1,13,12,1,92,4.1,94032,94,http://content7.flixster.com/movie/26/07/260725_det.jpg,0
58972,Nim's Island,410377,La isla de Nim,"http://ia.media-imdb.com/images/M/MV5BMTg0NTE5Mzg2NF5BMl5BanBnXkFtZTcwODY2MTY3MQ@@._V1._SY314_CR8,0,214,314_.jpg",2008,nims_island,5.7,96,48,48,50,5.9,24,13,11,54,3.1,45465,50,http://content9.flixster.com/movie/10/79/99/10799967_det.jpg,0
40952,Bee Season,387059,La huella del silencio,"http://ia.media-imdb.com/images/M/MV5BMTIxODcyMjI2MV5BMl5BanBnXkFtZTcwMjY0MjEzMQ@@._V1._SX214_CR0,0,214,314_.jpg",2005,bee_season,5.4,104,44,60,42,4.9,32,11,21,34,2.8,3415,37,http://content9.flixster.com/movie/10/87/02/10870235_det.jpg,5
3264,Buffy the Vampire Slayer,103893,Buffy the Vampire Slayer,"http://ia.media-imdb.com/images/M/MV5BMTIxMTkyNTc2MF5BMl5BanBnXkFtZTcwMDQ4ODAwMQ@@._V1._SX214_CR0,0,214,314_.jpg",1992,buffy_the_vampire_slayer,4.1,34,11,23,32,3.9,6,2,4,33,2.8,18735,44,http://content6.flixster.com/movie/11/12/50/11125008_det.jpg,-12
26375,Silver Streak,75223,El expreso de Chicago,"http://ia.media-imdb.com/images/M/MV5BNTM4NTI5NjI5OF5BMl5BanBnXkFtZTcwODU4MTcyMQ@@._V1._SY314_CR3,0,214,314_.jpg",1976,1019017-silver_streak,6.4,18,15,3,83,0,1,1,0,100,3.4,1982,68,http://content7.flixster.com/movie/25/52/255209_det.jpg,15
47805,Lassie,110305,El regreso de Lassie,"http://ia.media-imdb.com/images/M/MV5BMTYwNDg4NjMwMV5BMl5BanBnXkFtZTcwOTgzNTYxMQ@@._V1._SY314_CR5,0,214,314_.jpg",1994,1053155-lassie,6.8,8,6,2,75,0,2,2,0,100,2.9,2577,52,http://content8.flixster.com/movie/26/34/263402_det.jpg,23
3825,Coyote Ugly,200550,El bar Coyote,"http://ia.media-imdb.com/images/M/MV5BMTk1NzM1ODg4OF5BMl5BanBnXkFtZTcwMTQ3OTgyMQ@@._V1._SY314_CR3,0,214,314_.jpg",2000,coyote_ugly,3.9,94,20,74,21,3.6,27,5,22,18,3.2,65988,73,http://content7.flixster.com/movie/25/81/258105_det.jpg,-52
8461,Dragon Seed,36777,Estirpe de dragón,"http://ia.media-imdb.com/images/M/MV5BMTIzMDkxODM2NV5BMl5BanBnXkFtZTcwODQ5MjUyMQ@@._V1._SX214_CR0,0,214,314_.jpg",1944,dragon_seed,0,3,2,1,66,0,0,0,0,0,0,0,0,http://content6.flixster.com/movie/10/89/81/10898184_det.jpg,66
2322,Soldier,120157,Soldier,"http://ia.media-imdb.com/images/M/MV5BMTUwODM5NzM1MF5BMl5BanBnXkFtZTcwNDg1ODIyMQ@@._V1._SY314_CR9,0,214,314_.jpg",1998,1083934-soldier,3.5,50,5,45,10,3.6,15,2,13,13,2.8,5503,46,http://content9.flixster.com/movie/26/95/269595_det.jpg,-36
7198,The Pick-up Artist,93737,El cazachicas,"http://ia.media-imdb.com/images/M/MV5BMjE0NTA0Mjc5N15BMl5BanBnXkFtZTcwODA4OTQyMQ@@._V1._SY314_CR3,0,214,314_.jpg",1987,pickup_artist,5,20,11,9,55,5.2,6,3,3,50,2.8,1355,34,http://content7.flixster.com/movie/10/21/45/10214521_det.jpg,21
6649,Tunes of Glory,54412,Whisky y gloria,"http://ia.media-imdb.com/images/M/MV5BMTQ4MDE2MTYzN15BMl5BanBnXkFtZTcwNjA5NjQyMQ@@._V1._SY314_CR4,0,214,314_.jpg",1960,tunes_of_glory,5.7,6,4,2,66,0,0,0,0,0,0,0,0,http://content6.flixster.com/movie/29/79/297912_det.jpg,66
27776,Feux rouges,365190,Feux rouges,"http://ia.media-imdb.com/images/M/MV5BMTgxNDY2Mjk5N15BMl5BanBnXkFtZTcwMDcyODYyMQ@@._V1._SX214_CR0,0,214,314_.jpg",2004,red_lights,7.2,85,71,14,83,7.4,31,26,5,83,3.4,433,64,http://content6.flixster.com/movie/10/84/30/10843036_det.jpg,19
6461,Unforgiven,105695,Sin perdón,"http://ia.media-imdb.com/images/M/MV5BMTM2MjExNTEwMV5BMl5BanBnXkFtZTcwMzIyMDEyMQ@@._V1._SY314_CR10,0,214,314_.jpg",1992,1041911-unforgiven,8.5,56,54,2,96,7.5,11,9,2,81,4,27203,91,http://content9.flixster.com/movie/10/93/21/10932195_det.jpg,5
7982,"Janghwa, Hongryeon",365376,Dos hermanas,"http://ia.media-imdb.com/images/M/MV5BMjA2NDcwMjI4Ml5BMl5BanBnXkFtZTcwMDM0OTgyMQ@@._V1._SY314_CR4,0,214,314_.jpg",2003,1143939-1143939-tale_of_two_sisters,7.1,53,46,7,86,6.7,16,13,3,81,3.9,7458,83,http://content7.flixster.com/movie/10/84/07/10840797_det.jpg,3
7306,La ley de Herodes,221344,La ley de Herodes,"http://ia.media-imdb.com/images/M/MV5BMTg2MjAwMTIxN15BMl5BanBnXkFtZTcwMjM0OTQ1MQ@@._V1._SY314_CR3,0,214,314_.jpg",1999,la_ley_de_herodes,6.4,25,17,8,68,6.3,10,7,3,70,4,575,88,http://content9.flixster.com/movie/10/93/75/10937595_det.jpg,-20
6598,Step Into Liquid,308508,Step Into Liquid,"http://ia.media-imdb.com/images/M/MV5BMTkxNzE3MzU3Ml5BMl5BanBnXkFtZTcwNDc3MTYyMQ@@._V1._SY314_CR0,0,214,314_.jpg",2003,step_into_liquid,6.9,77,63,14,81,7.1,28,26,2,92,4.1,1308,91,http://content9.flixster.com/movie/25/39/253991_det.jpg,-10
32844,Waterloo Bridge,33238,El puente de Waterloo,http://ia.media-imdb.com/images/M/MV5BMTU5NjM5MzI4OF5BMl5BanBnXkFtZTcwMTQ1OTEyMQ@@._V1._SX77_SY140_.jpg,1940,waterloo_bridge,6.4,5,4,1,80,0,1,1,0,100,4,1003,88,http://content8.flixster.com/movie/29/42/14/2942146_det.jpg,-8
26178,Two for the Road,62407,Dos en la carretera,"http://ia.media-imdb.com/images/M/MV5BMTM5MjMxNTU3MF5BMl5BanBnXkFtZTcwMjg0OTEzMQ@@._V1._SY314_CR6,0,214,314_.jpg",1967,two_for_the_road,7.2,12,10,2,83,0,0,0,0,0,0,0,0,http://content6.flixster.com/movie/29/04/290492_det.jpg,83
5363,The New Guy,241760,Los feos también mojan,"http://ia.media-imdb.com/images/M/MV5BNTUxMTk4MzIyNl5BMl5BanBnXkFtZTcwNjE4NjQyMQ@@._V1._SY314_CR0,0,214,314_.jpg",2002,1112617-new_guy,3.1,91,6,85,6,3.5,22,3,19,13,3,9884,60,http://content7.flixster.com/movie/26/07/260721_det.jpg,-54
2208,The Lady Vanishes,30341,Alarma en el expreso,"http://ia.media-imdb.com/images/M/MV5BMTQ0MjQzMzcwMl5BMl5BanBnXkFtZTcwNjg5NjE1MQ@@._V1._SY314_CR3,0,214,314_.jpg",1938,1011813-lady_vanishes,8.3,33,32,1,96,0,3,3,0,100,4,4078,87,http://content8.flixster.com/movie/92/28/922862_det.jpg,9
6792,Sibirskiy tsiryulnik,120125,El barbero de Siberia,"http://ia.media-imdb.com/images/M/MV5BMTc4NDUwMDU3OV5BMl5BanBnXkFtZTcwMzU4MDYyMQ@@._V1._SX214_CR0,0,214,314_.jpg",1998,barber_of_siberia,0,3,0,3,0,0,0,0,0,0,0,0,0,http://content6.flixster.com/movie/88/71/66/8871668_det.jpg,0
2715,The Velocity of Gary* *(Not His Real Name),120878,La velocidad de la vida,"http://ia.media-imdb.com/images/M/MV5BMTc4MDIzNjY2MF5BMl5BanBnXkFtZTcwNzY0MTUyMQ@@._V1._SY314_CR0,0,214,314_.jpg",1998,velocity_of_gary,4.1,17,4,13,23,0,1,0,1,0,3.1,516,49,http://content8.flixster.com/movie/27/56/275698_det.jpg,-26
3087,Scrooged,96061,Los fantasmas atacan al jefe,"http://ia.media-imdb.com/images/M/MV5BMjA5NzE4NTE4NF5BMl5BanBnXkFtZTcwNTI1NDIyMQ@@._V1._SY314_CR3,0,214,314_.jpg",1988,scrooged,5.8,38,24,14,63,3.8,6,1,5,16,3.3,11201,68,http://content7.flixster.com/movie/26/58/265829_det.jpg,-5
245,The Glass Shield,109906,La placa de hielo,"http://ia.media-imdb.com/images/M/MV5BMTQzNDUyMTg2N15BMl5BanBnXkFtZTcwMTQ5OTAzMQ@@._V1._SX214_CR0,0,214,314_.jpg",1994,glass_shield,5.6,21,13,8,61,5.2,7,3,4,42,3,263,41,http://content9.flixster.com/movie/26/60/266023_det.jpg,20
55732,Martian Child,415965,El niño de Marte,"http://ia.media-imdb.com/images/M/MV5BMjExMDAxNzYzNV5BMl5BanBnXkFtZTcwMDQ3MDU1MQ@@._V1._SX214_CR0,0,214,314_.jpg",2007,martian_child,5,104,34,70,32,4.6,29,6,23,20,3.7,48559,73,http://content7.flixster.com/movie/10/17/78/10177873_det.jpg,-41
7390,Prey for Rock & Roll,307351,Prey for Rock & Roll,"http://ia.media-imdb.com/images/M/MV5BMTMzMzIwMjc4MF5BMl5BanBnXkFtZTcwMjI2MTYyMQ@@._V1._SY307_CR1,0,214,307_.jpg",2003,prey_for_rock_and_roll,5.8,46,26,20,56,6.3,14,10,4,71,3.4,876,66,http://content8.flixster.com/movie/10/89/95/10899534_det.jpg,-10
5353,Butterflies Are Free,68326,Las mariposas son libres,"http://ia.media-imdb.com/images/M/MV5BMjA5MDU5MDM1OV5BMl5BanBnXkFtZTcwMTczNTMyMQ@@._V1._SY314_CR1,0,214,314_.jpg",1972,butterflies_are_free,6.1,7,5,2,71,0,0,0,0,0,0,0,0,http://content8.flixster.com/movie/26/17/261710_det.jpg,71
61970,Project Moon Base,46213,Project Moon Base,"http://ia.media-imdb.com/images/M/MV5BMjE0ODE3ODc1NV5BMl5BanBnXkFtZTcwMjM4MTcxMQ@@._V1._SY314_CR10,0,214,314_.jpg",1953,project-moonbase,0,1,0,1,0,0,0,0,0,0,0,0,0,http://content9.flixster.com/movie/10/84/81/10848107_det.jpg,0
5629,Jonah: A VeggieTales Movie,298388,Jonah: A VeggieTales Movie,"http://ia.media-imdb.com/images/M/MV5BMTUxOTc2NDA4NF5BMl5BanBnXkFtZTcwMTk3NzIyMQ@@._V1._SY314_CR1,0,214,314_.jpg",2002,jonah_a_veggietales_movie,5.8,54,35,19,64,6.1,18,14,4,77,3.4,4629,70,http://content6.flixster.com/movie/10/94/42/10944208_det.jpg,-6
6348,Breakin' 2: Electric Boogaloo,86999,Breakin' 2: Electric Boogaloo,"http://ia.media-imdb.com/images/M/MV5BMjE1MTc5MTY4N15BMl5BanBnXkFtZTcwMTgwNzAyMQ@@._V1._SY314_CR3,0,214,314_.jpg",1984,electric_boogaloo_breakin_2,0,3,1,2,33,0,1,1,0,100,3.4,1507,66,http://content8.flixster.com/movie/10/86/74/10867438_det.jpg,-33
4070,Amy,118614,Amy,"http://ia.media-imdb.com/images/M/MV5BMTcwNjA2MTI2NV5BMl5BanBnXkFtZTcwNTcwMjgyMQ@@._V1._SY314_CR4,0,214,314_.jpg",1997,1104229-amy,5,14,6,8,42,6.1,6,4,2,66,3.7,361,76,http://content9.flixster.com/movie/26/68/266815_det.jpg,-34
2246,Stars and Bars,96166,Un señorito en Nueva York,"http://ia.media-imdb.com/images/M/MV5BMTg0Nzg4NzA3NV5BMl5BanBnXkFtZTcwODM5MDIyMQ@@._V1._SX214_CR0,0,214,314_.jpg",1988,stars_and_bars,0,1,1,0,100,0,0,0,0,0,0,0,0,http://content9.flixster.com/movie/92/87/09/9287099_det.gif,100
6561,The Mouse That Roared,53084,Un golpe de gracia,"http://ia.media-imdb.com/images/M/MV5BMTYxNjEwNjUyM15BMl5BanBnXkFtZTcwMjI4MDAwMQ@@._V1._SY314_CR0,0,214,314_.jpg",1959,mouse_that_roared,7.1,18,16,2,88,0,0,0,0,0,0,0,0,http://content9.flixster.com/movie/28/65/286519_det.jpg,88
3896,The Way of the Gun,202677,Secuestro infernal,"http://ia.media-imdb.com/images/M/MV5BMTc0MjAwNTExNV5BMl5BanBnXkFtZTcwNzI4NjEyMQ@@._V1._SX214_CR0,0,214,314_.jpg",2000,way_of_the_gun,5.4,102,48,54,47,4.9,24,10,14,41,3.3,5742,68,http://content7.flixster.com/movie/28/09/280993_det.jpg,-21
8783,The Village,368447,El bosque (The village),"http://ia.media-imdb.com/images/M/MV5BMTUxOTAwNjQ5MF5BMl5BanBnXkFtZTYwODkxODg2._V1._SY314_CR4,0,214,314_.jpg",2004,village,5.4,199,84,115,42,5.7,39,19,20,48,3,47806,59,http://content6.flixster.com/movie/10/91/54/10915468_det.jpg,-17
6338,Daddy Day Care,317303,Papá Canguro,"http://ia.media-imdb.com/images/M/MV5BMTY5NDk2MDAzM15BMl5BanBnXkFtZTYwODA5ODE3._V1._SX214_CR0,0,214,314_.jpg",2003,daddy_day_care,4.5,124,35,89,28,4.6,34,9,25,26,3.2,35165,63,http://content6.flixster.com/movie/25/81/258196_det.jpg,-35
26695,The Krays,99951,The Krays,"http://ia.media-imdb.com/images/M/MV5BMTU5NTEzMjgxNl5BMl5BanBnXkFtZTcwODA5NjAwMQ@@._V1._SX214_CR0,0,214,314_.jpg",1990,krays,6.4,12,10,2,83,0,2,2,0,100,3.7,1447,82,http://content6.flixster.com/movie/10/87/81/10878168_det.jpg,1
2317,Life During Wartime,119534,Life During Wartime,"http://ia.media-imdb.com/images/M/MV5BMTgwMTU2OTI4NV5BMl5BanBnXkFtZTcwMTM4MDEyMQ@@._V1._SY314_CR3,0,214,314_.jpg",1997,alarmist,5.6,11,6,5,54,0,1,0,1,0,0,0,0,http://content6.flixster.com/movie/10/85/12/10851272_det.jpg,54
8609,Our Hospitality,14341,La ley de la hospitalidad,"http://ia.media-imdb.com/images/M/MV5BMjA3NTI3Mjc3Ml5BMl5BanBnXkFtZTYwNzA2NzM2._V1._SY314_CR99,0,214,314_.jpg",1923,our_hospitality,9.5,17,17,0,100,0,0,0,0,0,0,0,0,http://content8.flixster.com/movie/10/98/24/10982454_det.jpg,100
122,Boomerang,103859,Boomerang: el príncipe de las mujeres,"http://ia.media-imdb.com/images/M/MV5BMTg1NTk3NTkzNl5BMl5BanBnXkFtZTcwNTk4MjAzMQ@@._V1._SY314_CR2,0,214,314_.jpg",1992,1039796-boomerang,4.8,27,10,17,37,5.4,8,4,4,50,2.8,4751,55,http://content6.flixster.com/movie/26/81/268128_det.jpg,-18
3952,The Contender,208874,Candidata al poder,"http://ia.media-imdb.com/images/M/MV5BMTQ5NjEzNDUxNV5BMl5BanBnXkFtZTcwNzMxNDcxMQ@@._V1._SY314_CR2,0,214,314_.jpg",2000,1100998-contender,6.7,128,97,31,75,6.2,34,25,9,73,3.5,2093,72,http://content7.flixster.com/movie/28/54/285405_det.jpg,3
860,Der bewegte Mann,109255,El hombre deseado,"http://ia.media-imdb.com/images/M/MV5BMTQ0MzYwMDY5OV5BMl5BanBnXkFtZTYwNDc3Mjk5._V1._SY314_CR0,0,214,314_.jpg",1994,maybe_maybe_not,5.9,9,5,4,55,0,3,2,1,66,3.5,359,64,http://content7.flixster.com/movie/10/85/95/10859537_det.jpg,-9
5897,Das Arche Noah Prinzip,86911,El principio del arca de Noé,"http://ia.media-imdb.com/images/M/MV5BMTI4MDYxNzExMV5BMl5BanBnXkFtZTcwOTA2MzMyMQ@@._V1._SY314_CR5,0,214,314_.jpg",1984,noahs_ark_principle,0,0,0,0,0,0,0,0,0,0,0,0,0,http://content8.flixster.com/movie/64/02/37/6402370_det.jpg,0
54734,Sydney White,815244,Sydney White,"http://ia.media-imdb.com/images/M/MV5BMTIxNTQwMTM1MF5BMl5BanBnXkFtZTcwNTg1MzU1MQ@@._V1._SX214_CR0,0,214,314_.jpg",2007,sydney_white,5,81,30,51,37,4.7,20,5,15,25,3.5,526699,74,http://content6.flixster.com/movie/99/50/88/9950880_det.jpg,-37
5090,Notre-Dame de Paris,50781,Nuestra señora de París,"http://ia.media-imdb.com/images/M/MV5BMTU2Mjc4OTc3OF5BMl5BanBnXkFtZTcwMTczNzcxMQ@@._V1._SY314_CR1,0,214,314_.jpg",1956,1073312-hunchback_of_notre_dame,0,0,0,0,0,0,0,0,0,0,0,0,0,http://content7.flixster.com/movie/10/89/25/10892517_det.jpg,0
8853,A Small Circle of Friends,81528,Pequeño círculo de amigos,"http://ia.media-imdb.com/images/M/MV5BMjEzOTEzODU3OF5BMl5BanBnXkFtZTcwMjgyOTUyMQ@@._V1._SY314_CR8,0,214,314_.jpg",1980,small_circle_of_friends,0,1,1,0,100,0,0,0,0,0,0,0,0,http://content9.flixster.com/movie/10/91/26/10912683_det.jpg,100
3165,3-4 x jûgatsu,98967,3-4 x jûgatsu,"http://ia.media-imdb.com/images/M/MV5BMjEwMjk3NzY2Nl5BMl5BanBnXkFtZTcwMjY1ODcxMQ@@._V1._SY314_CR6,0,214,314_.jpg",1990,1088532-boiling_point,6.8,7,6,1,85,0,1,1,0,100,3.5,702,66,http://content7.flixster.com/movie/34/85/50/3485505_det.jpg,19
53000,28 Weeks Later,463854,28 semanas después,"http://ia.media-imdb.com/images/M/MV5BMTMyNzg2MjE5MF5BMl5BanBnXkFtZTcwMDUyNjM1MQ@@._V1._SY314_CR7,0,214,314_.jpg",2007,28_weeks_later,6.6,182,128,54,70,7,39,30,9,76,3.4,266576,66,http://content6.flixster.com/movie/10/86/37/10863760_det.jpg,4
5669,Bowling for Columbine,310793,Bowling for Columbine,"http://ia.media-imdb.com/images/M/MV5BNDA0MjUxNDI1N15BMl5BanBnXkFtZTYwOTEzMDg5._V1._SX214_CR0,0,214,314_.jpg",2002,bowling_for_columbine,8.2,160,154,6,96,7.7,30,28,2,93,3.5,24080,81,http://content8.flixster.com/movie/10/93/45/10934550_det.jpg,15
3632,Monsieur Verdoux,39631,Monsieur Verdoux,"http://ia.media-imdb.com/images/M/MV5BMjE5ODU3MDk4N15BMl5BanBnXkFtZTcwNTAxMjUyMQ@@._V1._SY314_CR27,0,214,314_.jpg",1947,monsieur_verdoux,8,24,23,1,95,6.8,5,4,1,80,4,1388,88,http://content8.flixster.com/movie/29/02/290214_det.jpg,7
5121,Stroszek,75276,Stroszek,"http://ia.media-imdb.com/images/M/MV5BMTk5MDM2MDA4NV5BMl5BanBnXkFtZTcwOTQ4MzcxMQ@@._V1._SY314_CR2,0,214,314_.jpg",1977,stroszek,8.2,13,13,0,100,0,3,3,0,100,4.3,1933,93,http://content7.flixster.com/movie/29/96/299617_det.jpg,7
6603,La double vie de Véronique,101765,La doble vida de Verónica,"http://ia.media-imdb.com/images/M/MV5BMTc3OTUyNjE3Ml5BMl5BanBnXkFtZTcwNzY4MzkzMQ@@._V1._SY314_CR4,0,214,314_.jpg",1991,double_life_of_veronique,7.6,25,21,4,84,7.6,5,5,0,100,4.3,5676,92,http://content8.flixster.com/movie/10/94/04/10940458_det.jpg,-8
1539,Twin Town,120394,Twin Town,"http://ia.media-imdb.com/images/M/MV5BMTgxNTQxNTQwNV5BMl5BanBnXkFtZTcwMTk0NDkyMQ@@._V1._SY314_CR3,0,214,314_.jpg",1997,twin_town,5.4,13,6,7,46,0,4,1,3,25,4.2,2298,90,http://content8.flixster.com/movie/94/77/97/9477974_det.jpg,-44
6923,Sherlock Holmes and the Voice of Terror,35318,La voz del terror,"http://ia.media-imdb.com/images/M/MV5BMTMzNDM5NDc2NV5BMl5BanBnXkFtZTcwMjc3MzAwMQ@@._V1._SY314_CR7,0,214,314_.jpg",1942,sherlock_holmes_and_the_voice_of_terror,0,3,2,1,66,0,0,0,0,0,0,0,0,http://content7.flixster.com/movie/29/80/298025_det.jpg,66
160,Congo,112715,Congo,"http://ia.media-imdb.com/images/M/MV5BNjI3MTE5NTMzOF5BMl5BanBnXkFtZTcwMzkyOTAyMQ@@._V1._SY314_CR4,0,214,314_.jpg",1995,congo,3.6,42,9,33,21,3.2,12,1,11,8,2.6,7008,34,http://content7.flixster.com/movie/25/85/258597_det.jpg,-13
4223,Enemy at the Gates,215750,Enemigo a las puertas,"http://ia.media-imdb.com/images/M/MV5BMTIwNTE0Njc0Nl5BMl5BanBnXkFtZTcwMTE5MTAzMQ@@._V1._SY314_CR3,0,214,314_.jpg",2001,enemy_at_the_gates,5.6,135,72,63,53,5.6,31,16,15,51,3.6,31546,81,http://content9.flixster.com/movie/10/89/26/10892639_det.jpg,-28
60990,Kohayagawa-ke no aki,55052,Kohayagawa-ke no aki,"http://ia.media-imdb.com/images/M/MV5BMTkxMzc3MzQ3OF5BMl5BanBnXkFtZTcwMDM4MDUyMQ@@._V1._SY314_CR5,0,214,314_.jpg",1961,10008436-the_end_of_summer,0,4,4,0,100,0,0,0,0,0,0,0,0,http://content6.flixster.com/movie/10/89/13/10891332_det.jpg,100
7070,Red River,40724,Río rojo,"http://ia.media-imdb.com/images/M/MV5BMTg5Mzc3NjcwMF5BMl5BanBnXkFtZTcwODE5NjEzMQ@@._V1._SY314_CR8,0,214,314_.jpg",1948,red_river,8.6,18,18,0,100,0,3,3,0,100,0,0,0,http://content7.flixster.com/movie/11/15/10/11151073_det.jpg,100
1898,The Land Girls,119494,Amores en tiempos de guerra,"http://ia.media-imdb.com/images/M/MV5BMTAzNjkzOTgwODleQTJeQWpwZ15BbWU3MDk3NzE2MTE@._V1._SY314_CR2,0,214,314_.jpg",1998,land_girls,6.7,17,11,6,64,6.1,7,2,5,28,3.3,693,54,http://content7.flixster.com/movie/15/52/22/1552225_det.jpg,10
6975,Funny Games U.S.,808279,Funny Games,"http://ia.media-imdb.com/images/M/MV5BMTg4OTExNTYzMV5BMl5BanBnXkFtZTcwOTg1MDU1MQ@@._V1._SX214_CR0,0,214,314_.jpg",2007,1175174-funny_games,5.6,138,71,67,51,4.7,34,13,21,38,3.2,16153,54,http://content8.flixster.com/movie/10/88/03/10880338_det.jpg,-3
55278,Sleuth,857265,La huella,"http://ia.media-imdb.com/images/M/MV5BMTM4Nzc0MTA5MF5BMl5BanBnXkFtZTcwNDI1MjI1MQ@@._V1._SX214_CR0,0,214,314_.jpg",2007,sleuth,5.1,118,42,76,35,5.1,30,10,20,33,3.2,9724,53,http://content8.flixster.com/movie/99/66/35/9966350_det.jpg,-18
2571,The Matrix,133093,Matrix,"http://ia.media-imdb.com/images/M/MV5BMjEzNjg1NTg2NV5BMl5BanBnXkFtZTYwNjY3MzQ5._V1._SY314_CR4,0,214,314_.jpg",1999,matrix,7.4,125,108,17,86,6.2,28,19,9,67,3.6,207333,81,http://content7.flixster.com/movie/16/90/52/1690525_det.jpg,5
492,Manhattan Murder Mystery,107507,Misterioso asesinato en Manhattan,"http://ia.media-imdb.com/images/M/MV5BMTg0MzIyNjQ1NF5BMl5BanBnXkFtZTcwODU2MjYxMQ@@._V1._SY314_CR3,0,214,314_.jpg",1993,manhattan_murder_mystery,6.9,21,19,2,90,0,3,3,0,100,3.7,4405,81,http://content8.flixster.com/movie/11/12/42/11124250_det.jpg,9
33564,Divorzio all'italiana,55913,Divorcio a la italiana,"http://ia.media-imdb.com/images/M/MV5BMTIwNTY3OTIxNV5BMl5BanBnXkFtZTcwOTY1MzgyMQ@@._V1._SY314_CR4,0,214,314_.jpg",1961,divorce_italian_style,7.9,16,16,0,100,7.8,5,5,0,100,4,1181,90,http://content9.flixster.com/movie/10/89/11/10891115_det.jpg,10
6139,The Tempest,81613,The Tempest,http://ia.media-imdb.com/images/M/MV5BMTM4NDM3ODA0MF5BMl5BanBnXkFtZTcwODg5NjQyMQ@@._V1._SX98_SY140_.jpg,1979,1087280-tempest,0,4,3,1,75,0,0,0,0,0,0,0,0,http://content7.flixster.com/movie/10/87/71/10877137_det.jpg,75
6351,Hysterical Blindness,290664,Ceguera histérica,"http://ia.media-imdb.com/images/M/MV5BMTM5MDk1NjE1OF5BMl5BanBnXkFtZTYwMjgzNjk5._V1._SY314_CR0,0,214,314_.jpg",2002,hysterical_blindness,5.4,10,7,3,70,0,3,2,1,66,0,0,0,http://content8.flixster.com/movie/10/88/70/10887014_det.jpg,70
8792,Octane,323465,Octane,"http://ia.media-imdb.com/images/M/MV5BMjAzMTg3Nzg4NV5BMl5BanBnXkFtZTcwMzYxNTYyMQ@@._V1._SY314_CR11,0,214,314_.jpg",2003,pulse2004,3.9,6,1,5,16,0,0,0,0,0,0,0,0,http://content7.flixster.com/movie/27/99/279925_det.jpg,16
25839,Nothing Sacred,29322,La reina de Nueva York,"http://ia.media-imdb.com/images/M/MV5BMjA2NTk0MDkwN15BMl5BanBnXkFtZTcwNzM1NDAyMQ@@._V1._SY314_CR2,0,214,314_.jpg",1937,nothing_sacred,9,9,9,0,100,0,0,0,0,0,0,0,0,http://content8.flixster.com/movie/28/98/289818_det.jpg,100
43923,Madea's Family Reunion,455612,Madea's Family Reunion,"http://ia.media-imdb.com/images/M/MV5BMTIwNDA0MTQ2N15BMl5BanBnXkFtZTcwNzc1NTIzMQ@@._V1._SX214_CR0,0,214,314_.jpg",2006,madeas_family_reunion,4.5,53,14,39,26,4.9,17,7,10,41,3.7,23761,85,http://content9.flixster.com/movie/10/87/66/10876631_det.jpg,-59
2014,Freaky Friday,322330,Ponte en mi lugar,"http://ia.media-imdb.com/images/M/MV5BMjEzNTE3OTQwM15BMl5BanBnXkFtZTcwNzgyMjAwMQ@@._V1._SY311_CR1,0,214,311_.jpg",2003,freaky_friday,7,140,123,17,87,7,34,29,5,85,2.9,73112,60,http://content8.flixster.com/movie/55/05/69/5505698_det.jpg,27
3056,Oxygen,160620,Oxygen,"http://ia.media-imdb.com/images/M/MV5BMTY4MTUxNzM4Ml5BMl5BanBnXkFtZTcwOTM0OTYyMQ@@._V1._SY314_CR1,0,214,314_.jpg",1999,oxygen,6.5,10,7,3,70,0,0,0,0,0,0,0,0,http://content6.flixster.com/movie/27/85/278592_det.jpg,70
32862,With Six You Get Eggroll,63821,El novio de mamá,"http://ia.media-imdb.com/images/M/MV5BMTU0NDk2ODQwN15BMl5BanBnXkFtZTcwNTMwNTgyMQ@@._V1._SY314_CR4,0,214,314_.jpg",1968,with_six_you_get_eggroll,0,2,2,0,100,0,0,0,0,0,0,0,0,http://content9.flixster.com/movie/25/08/250891_det.jpg,100
3908,Urban Legends: Final Cut,192731,Leyenda urbana 2,"http://ia.media-imdb.com/images/M/MV5BNTIwNzMyMzIzM15BMl5BanBnXkFtZTcwODkwNjUxMQ@@._V1._SX214_CR0,0,214,314_.jpg",2000,urban_legends_final_cut,3,78,7,71,8,2.6,20,1,19,5,2.5,5717,35,http://content7.flixster.com/movie/10/94/63/10946361_det.jpg,-27
3275,The Boondock Saints,144117,Los elegidos,"http://ia.media-imdb.com/images/M/MV5BMTIzODA2NTUyM15BMl5BanBnXkFtZTYwODQ2Mjk4._V1._SY314_CR6,0,214,314_.jpg",1999,boondock_saints,4,21,4,17,19,0,1,0,1,0,4.2,104281,93,http://content9.flixster.com/movie/10/93/80/10938019_det.jpg,-74
6349,Breakin',86998,Breakin',"http://ia.media-imdb.com/images/M/MV5BMjA2OTc4MjUxMV5BMl5BanBnXkFtZTYwNDg2Mjg5._V1._SX214_CR0,0,214,314_.jpg",1984,breakin,4,6,2,4,33,0,0,0,0,0,0,0,0,http://content9.flixster.com/movie/10/94/49/10944963_det.jpg,33
3880,The Ballad of Ramblin' Jack,236008,The Ballad of Ramblin' Jack,"http://ia.media-imdb.com/images/M/MV5BMTQ5NTYyMDcyOF5BMl5BanBnXkFtZTcwMzA2NzAyMQ@@._V1._SY314_CR2,0,214,314_.jpg",2000,ballad_of_ramblin_jack,7.4,18,17,1,94,0,3,3,0,100,3.6,162,48,http://content8.flixster.com/movie/26/39/263998_det.jpg,46
952,Around the World in 80 Days,327437,La vuelta al mundo en 80 días,"http://ia.media-imdb.com/images/M/MV5BMTIzNDgyNTc3M15BMl5BanBnXkFtZTcwMTc5OTYyMQ@@._V1._SY314_CR3,0,214,314_.jpg",2004,around_the_world_in_80_days,4.8,127,39,88,30,4.7,33,9,24,27,2.7,14038,45,http://content7.flixster.com/movie/11/14/86/11148613_det.jpg,-15
4044,Breaker! Breaker!,75783,El poder de la fuerza,"http://ia.media-imdb.com/images/M/MV5BMjA4Njg1NzYzMF5BMl5BanBnXkFtZTcwMjA3NzcxMQ@@._V1._SY314_CR4,0,214,314_.jpg",1977,breaker_breaker,0,1,0,1,0,0,0,0,0,0,0,0,0,http://content7.flixster.com/movie/10/89/13/10891301_det.jpg,0
3566,The Big Kahuna,189584,El pez gordo,"http://ia.media-imdb.com/images/M/MV5BMTkwNjE5NDQ4NV5BMl5BanBnXkFtZTcwMzM2NTc0MQ@@._V1._SY314_CR2,0,214,314_.jpg",1999,big_kahuna,6.4,76,56,20,73,6.4,22,15,7,68,3.3,1772,65,http://content7.flixster.com/movie/28/12/281217_det.jpg,8
5837,Legion of the Dead,441041,Legion of the Dead,"http://ia.media-imdb.com/images/M/MV5BMTY4MjA4NDkxN15BMl5BanBnXkFtZTcwMDU0NDIzMQ@@._V1._SY314_CR5,0,214,314_.jpg",2005,1156538-legion_of_the_dead,0,0,0,0,0,0,0,0,0,0,0,0,0,http://content8.flixster.com/movie/10/85/37/10853770_det.jpg,0
3446,Funny Bones,113133,Los comediantes (Funny Bones),"http://ia.media-imdb.com/images/M/MV5BODk0NzYzMzc4OF5BMl5BanBnXkFtZTcwOTQyNTUyMQ@@._V1._SY314_CR1,0,214,314_.jpg",1995,funny_bones,6.5,17,11,6,64,0,2,1,1,50,3.4,706,72,http://content7.flixster.com/movie/10/91/92/10919245_det.jpg,-8
2703,Broken Vessels,149964,Broken Vessels,"http://ia.media-imdb.com/images/M/MV5BMTM1MTIxNDI5M15BMl5BanBnXkFtZTcwMzA2NzUyMQ@@._V1._SY314_CR3,0,214,314_.jpg",1998,broken_vessels,5.7,14,9,5,64,0,3,2,1,66,0,0,0,http://content6.flixster.com/movie/28/27/282796_det.jpg,64
1270,Back to the Future,88763,Regreso al futuro,"http://ia.media-imdb.com/images/M/MV5BMTM0MDE3ODQ5Ml5BMl5BanBnXkFtZTcwMDI3MzYwMg@@._V1._SY314_CR8,0,214,314_.jpg",1985,back_to_the_future,8.4,54,52,2,96,7.3,6,5,1,83,3.8,126816,88,http://content6.flixster.com/movie/31/17/311700_det.jpg,8
7438,Kill Bill: Vol. 2,378194,Kill Bill: Volumen 2,"http://ia.media-imdb.com/images/M/MV5BMTIwNzQ3MDIxMV5BMl5BanBnXkFtZTcwMDIxMzUyMQ@@._V1._SX214_CR0,0,214,314_.jpg",2004,kill_bill_vol_2,7.7,226,193,33,85,7.7,43,35,8,81,3.8,162324,87,http://content9.flixster.com/movie/26/69/266911_det.jpg,-2
7818,School for Scoundrels,462519,Escuela de pringaos,"http://ia.media-imdb.com/images/M/MV5BMTM3ODExNjE2NV5BMl5BanBnXkFtZTcwMTIwNTczMQ@@._V1._SX214_CR0,0,214,314_.jpg",2006,school_for_scoundrels,4.6,137,35,102,25,4.5,32,8,24,25,3.2,39981,57,http://content7.flixster.com/movie/27/22/94/2722945_det.jpg,-32
34336,Must Love Dogs,417001,...Y que le gusten los perros,"http://ia.media-imdb.com/images/M/MV5BNDE3MTM5MTkzOF5BMl5BanBnXkFtZTcwNDYzNjEzMQ@@._V1._SY314_CR32,0,214,314_.jpg",2005,must_love_dogs,5,145,50,95,34,5,32,11,21,34,3,16710,57,http://content6.flixster.com/movie/10/87/23/10872352_det.jpg,-23
4866,The Last Castle,272020,La última fortaleza,"http://ia.media-imdb.com/images/M/MV5BMTM0Mjg3NjY4MV5BMl5BanBnXkFtZTcwMjc1MTQyMQ@@._V1._SY302_CR1,0,214,302_.jpg",2001,last_castle,5.6,113,59,54,52,5.6,27,14,13,51,3.4,9259,73,http://content9.flixster.com/movie/10/83/84/10838491_det.jpg,-21
1877,Little Men,145048,Hombrecitos,"http://ia.media-imdb.com/images/M/MV5BMTQ2Njc5NzkzN15BMl5BanBnXkFtZTcwMzcwNjUyMQ@@._V1._SX214_CR0,0,214,314_.jpg",1997,1081316-little_men,4.6,7,1,6,14,0,3,0,3,0,3.5,85,63,http://content7.flixster.com/movie/10/55/44/10554493_det.gif,-49
6825,The Reluctant Astronaut,62190,The Reluctant Astronaut,"http://ia.media-imdb.com/images/M/MV5BMTg0MTE2ODM4Ml5BMl5BanBnXkFtZTcwMTk2NDEyMQ@@._V1._SY314_CR4,0,214,314_.jpg",1967,reluctant_astronaut,0,0,0,0,0,0,0,0,0,0,0,0,0,http://content9.flixster.com/movie/65/83/95/6583959_det.jpg,0
5928,The Border,83678,La frontera,"http://ia.media-imdb.com/images/M/MV5BMjAxNjIyNDgwNF5BMl5BanBnXkFtZTcwNDIxMTUyMQ@@._V1._SY314_CR4,0,214,314_.jpg",1982,1002907-border,6.7,9,8,1,88,0,0,0,0,0,0,0,0,http://content8.flixster.com/movie/27/58/275894_det.jpg,88
6769,Mambo italiano,330602,Mambo italiano,http://ia.media-imdb.com/images/M/MV5BMTcyODczNzI5OF5BMl5BanBnXkFtZTcwMzc0NDYyMQ@@._V1._SX135_SY192_.jpg,2003,mambo_italiano,4.7,72,23,49,31,5,23,8,15,34,3.3,1531,64,http://content9.flixster.com/movie/10/91/63/10916359_det.jpg,-33
1104,A Streetcar Named Desire,44081,Un tranvía llamado deseo,"http://ia.media-imdb.com/images/M/MV5BMTk3OTQ4MzY3M15BMl5BanBnXkFtZTcwODM0ODcyMg@@._V1._SX214_CR0,0,214,314_.jpg",1951,1020333-streetcar_named_desire,8.5,46,45,1,97,8.5,5,5,0,100,3.9,13151,88,http://content6.flixster.com/movie/25/45/254524_det.jpg,9
7122,Le roi de coeur,60908,Rey de corazones,"http://ia.media-imdb.com/images/M/MV5BMTMyNjM3Nzg4Ml5BMl5BanBnXkFtZTcwNTMzMjAwMQ@@._V1._SY314_CR1,0,214,314_.jpg",1966,1011624-king_of_hearts,7.4,10,9,1,90,0,2,1,1,50,4,779,86,http://content9.flixster.com/movie/10/54/32/10543255_det.jpg,4
38600,Factotum,417658,Factotum,http://ia.media-imdb.com/images/M/MV5BMTMzMDYzOTg2N15BMl5BanBnXkFtZTcwMzE3ODQzMQ@@._V1._SX179_SY265_.jpg,2005,factotum,6.8,111,84,27,75,6.5,29,17,12,58,3.2,9868,51,http://content6.flixster.com/movie/21/37/16/2137160_det.jpg,24
8125,Sunrise: A Song of Two Humans,18455,Amanecer,"http://ia.media-imdb.com/images/M/MV5BMTU1ODIyMDQ5N15BMl5BanBnXkFtZTcwMDI2MDEyMQ@@._V1._SY314_CR7,0,214,314_.jpg",1927,sunrise,8.8,38,37,1,97,7.7,8,7,1,87,4.4,2918,93,http://content6.flixster.com/movie/92/32/923216_det.jpg,4
52435,How the Grinch Stole Christmas,170016,El grinch,"http://ia.media-imdb.com/images/M/MV5BMTM2NzgzNTk2Nl5BMl5BanBnXkFtZTcwMjUxNjUyMQ@@._V1._SX214_CR0,0,214,314_.jpg",2000,how_the_grinch_stole_christmas,5.6,127,67,60,52,5.2,31,16,15,51,3.1,34926,57,http://content9.flixster.com/movie/25/55/255591_det.jpg,-5
2203,Shadow of a Doubt,36342,La sombra de una duda,"http://ia.media-imdb.com/images/M/MV5BMTI4MjI4NDE5Nl5BMl5BanBnXkFtZTcwMDcyNTIyMQ@@._V1._SY314_CR1,0,214,314_.jpg",1943,1018688-shadow_of_a_doubt,8.9,30,30,0,100,0,4,4,0,100,4,5376,89,http://content6.flixster.com/movie/10/89/08/10890840_det.jpg,11
6558,Curly Sue,101635,La pequeña pícara,"http://ia.media-imdb.com/images/M/MV5BOTQzMDE5ODAyMV5BMl5BanBnXkFtZTcwMDQwMTYyMQ@@._V1._SX214_CR0,0,214,314_.jpg",1991,curly_sue,3.8,11,1,10,9,0,2,1,1,50,2.8,3986,49,http://content8.flixster.com/movie/10/88/36/10883626_det.jpg,-40
7338,Richard III,114279,Ricardo III (Richard III),"http://ia.media-imdb.com/images/M/MV5BMjEzMjAxOTQzMV5BMl5BanBnXkFtZTcwMTYyNjIyMQ@@._V1._SY314_CR0,0,214,314_.jpg",1995,1068177-richard_iii,8.1,43,41,2,95,7.6,11,10,1,90,3.7,1552,82,http://content7.flixster.com/movie/26/89/268909_det.jpg,13
3866,Sunset Blvd.,43014,El crepúsculo de los dioses,"http://ia.media-imdb.com/images/M/MV5BMjIzNjMwNjcwMl5BMl5BanBnXkFtZTcwNzU1NDE3Mw@@._V1._SX214_CR0,0,214,314_.jpg",1950,sunset_boulevard,9.2,52,51,1,98,8.2,7,7,0,100,4.3,12588,95,http://content7.flixster.com/movie/10/88/29/10882989_det.jpg,3
3537,Where the Money Is,149367,Donde esté el dinero,"http://ia.media-imdb.com/images/M/MV5BMjE2MzY3NTExMF5BMl5BanBnXkFtZTcwNjU2ODkxMQ@@._V1._SY314_CR4,0,214,314_.jpg",2000,where_the_money_is,5.3,74,34,40,45,5.6,19,10,9,52,3,517,36,http://content7.flixster.com/movie/26/66/266625_det.jpg,9
3677,The Boys of Baraka,444608,The Boys of Baraka,"http://ia.media-imdb.com/images/M/MV5BMTgxMjYxNDg1Ml5BMl5BanBnXkFtZTcwODU3NzgyMQ@@._V1._SY314_CR0,0,214,314_.jpg",2005,boys_of_baraka,6.8,42,31,11,73,6.8,13,10,3,76,4,627,84,http://content9.flixster.com/movie/72/91/87/7291875_det.jpg,-11
2723,Mystery Men,132347,Hombres misteriosos,"http://ia.media-imdb.com/images/M/MV5BMTM2NjM0NTIzN15BMl5BanBnXkFtZTcwNTg4MjEyMQ@@._V1._SY314_CR3,0,214,314_.jpg",1999,mystery_men,5.7,100,60,40,60,5.7,28,17,11,60,2.8,14333,52,http://content6.flixster.com/movie/25/66/256628_det.jpg,8
8746,King of the Ants,328031,King of the Ants,"http://ia.media-imdb.com/images/M/MV5BNzk5NDE2OTYzNV5BMl5BanBnXkFtZTcwNzY1NTYyMQ@@._V1._SY314_CR4,0,214,314_.jpg",2003,1132084-king_of_the_ants,7.2,8,8,0,100,0,0,0,0,0,0,0,0,http://content7.flixster.com/movie/25/24/71/2524717_det.jpg,100
599,The Wild Bunch,65214,Grupo salvaje,"http://ia.media-imdb.com/images/M/MV5BMTMxODIxMzcyN15BMl5BanBnXkFtZTYwOTU5MzY5._V1._SY314_CR8,0,214,314_.jpg",1969,1059489-wild_bunch,8.8,38,37,1,97,8.2,7,6,1,85,4,8004,90,http://content7.flixster.com/movie/26/74/267417_det.jpg,7
7090,Ying xiong,299977,Hero,"http://ia.media-imdb.com/images/M/MV5BMTk5NjQyMzIwM15BMl5BanBnXkFtZTcwODQyNjYyMQ@@._V1._SX214_CR0,0,214,314_.jpg",2002,the-hero2004,0,0,0,0,0,0,0,0,0,0,0,0,0,http://content7.flixster.com/movie/10/84/81/10848177_det.jpg,0
5524,Blue Crush,300532,En el filo de las olas,"http://ia.media-imdb.com/images/M/MV5BMTY0NDU0ODIzNl5BMl5BanBnXkFtZTYwMDgxMzg5._V1._SY314_CR4,0,214,314_.jpg",2002,1113404-crush,5,78,27,51,34,5,24,8,16,33,3.2,804,58,http://content6.flixster.com/movie/10/88/47/10884704_det.jpg,-24
1027,Robin Hood: Prince of Thieves,102798,"Robin Hood, príncipe de los ladrones","http://ia.media-imdb.com/images/M/MV5BMTI2NzY5Mjk4OV5BMl5BanBnXkFtZTYwODExOTk5._V1._SY314_CR10,0,214,314_.jpg",1991,robin_hood_prince_of_thieves,5.2,27,15,12,55,0,2,1,1,50,3.4,30722,72,http://content6.flixster.com/movie/10/93/73/10937328_det.jpg,-17
3602,G.I. Blues,53848,G.I. Blues,"http://ia.media-imdb.com/images/M/MV5BNjMwNzI2NjMxM15BMl5BanBnXkFtZTcwNjgwNjAyMQ@@._V1._SY314_CR4,0,214,314_.jpg",1960,gi_blues,4.7,5,0,5,0,0,0,0,0,0,0,0,0,http://content9.flixster.com/movie/25/95/259591_det.jpg,0
6815,30 Days of Night,389722,30 días de oscuridad,"http://ia.media-imdb.com/images/M/MV5BMTQyMjc4MjExOF5BMl5BanBnXkFtZTcwMDI4ODg1MQ@@._V1._SY314_CR9,0,214,314_.jpg",2007,30_days_of_night,5.5,150,73,77,48,5.1,28,13,15,46,3.3,146766,57,http://content7.flixster.com/movie/10/18/32/10183253_det.jpg,-9
736,Twister,117998,Twister,"http://ia.media-imdb.com/images/M/MV5BMjE3NDMzODA2M15BMl5BanBnXkFtZTcwMDA5MDkxMQ@@._V1._SX214_CR0,0,214,314_.jpg",1996,1071167-twister,6,49,28,21,57,6.7,10,7,3,70,3.2,45771,62,http://content8.flixster.com/movie/26/63/266302_det.jpg,-5
4943,At the Earth's Core,74157,En el corazón de la tierra,"http://ia.media-imdb.com/images/M/MV5BMTQ0ODcyNzAzOV5BMl5BanBnXkFtZTcwMDI4OTMyMQ@@._V1._SX214_CR0,0,214,314_.jpg",1976,at_the_earths_core,4.4,6,2,4,33,0,1,0,1,0,2.9,800,35,http://content8.flixster.com/movie/26/43/264306_det.jpg,-2
2369,Desperately Seeking Susan,89017,Buscando a Susan desesperadamente,"http://ia.media-imdb.com/images/M/MV5BMjA5NDkyNTM0OV5BMl5BanBnXkFtZTcwMTc0MTQyMQ@@._V1._SY216_CR36,0,214,216_.jpg",1985,desperately_seeking_susan,6.7,23,20,3,86,0,3,3,0,100,2.8,3449,55,http://content9.flixster.com/movie/10/85/87/10858779_det.jpg,31
2048,The Great Mouse Detective,91149,"Basil, el ratón superdetective","http://ia.media-imdb.com/images/M/MV5BMTI2MzUyMDQ5NV5BMl5BanBnXkFtZTYwMzcxNjg5._V1._SX214_CR0,0,214,314_.jpg",1986,the-great-mouse-detective,6.8,15,12,3,80,0,2,2,0,100,3.3,8687,70,http://content9.flixster.com/movie/25/12/251227_det.jpg,10
51933,Pride,475355,Pride,"http://ia.media-imdb.com/images/M/MV5BMTIxMjk2MTM5NF5BMl5BanBnXkFtZTcwMDA0OTM0MQ@@._V1._SX214_CR0,0,214,314_.jpg",2007,pride,5.5,107,49,58,45,5.5,34,15,19,44,3.6,27617,73,http://content8.flixster.com/movie/10/95/41/10954118_det.jpg,-28
4150,Signs & Wonders,230783,Signs & Wonders,"http://ia.media-imdb.com/images/M/MV5BMTQ0NTY1NTM5M15BMl5BanBnXkFtZTcwMzY1MTcxMQ@@._V1._SY314_CR4,0,214,314_.jpg",2000,signs_and_wonders,6,27,18,9,66,6.6,12,9,3,75,3,91,35,http://content6.flixster.com/movie/10/88/73/10887344_det.jpg,31
5372,Calamity Jane,45591,Doris Day en el Oeste,"http://ia.media-imdb.com/images/M/MV5BMTk3NTY4MDE0OF5BMl5BanBnXkFtZTcwNzQwNDgyMQ@@._V1._SY314_CR26,0,214,314_.jpg",1953,1003399-calamity_jane,5.7,9,6,3,66,0,0,0,0,0,0,0,0,http://content8.flixster.com/movie/10/20/45/10204554_det.jpg,66
6783,La règle du jeu,31885,La règle du jeu,"http://ia.media-imdb.com/images/M/MV5BMTYyNjA4OTc1M15BMl5BanBnXkFtZTcwODg2NDQyMQ@@._V1._SY314_CR4,0,214,314_.jpg",1939,1017971-rules_of_the_game,9.1,37,36,1,97,9,10,10,0,100,4.3,2952,91,http://content8.flixster.com/movie/31/13/311306_det.jpg,6
6756,Casa de los babys,303830,Casa de los babys,"http://ia.media-imdb.com/images/M/MV5BMTM0MzI0Mjk5MV5BMl5BanBnXkFtZTcwMjc5MDYyMQ@@._V1._SX214_CR0,0,214,314_.jpg",2003,casa_de_los_babys,6,105,61,44,58,5.8,29,16,13,55,3.2,515,50,http://content7.flixster.com/movie/10/86/91/10869185_det.jpg,8
7460,Coffee and Cigarettes,379217,Coffee and Cigarettes,"http://ia.media-imdb.com/images/M/MV5BNzcyNTU4NjIxNV5BMl5BanBnXkFtZTcwMTgyNDYyMQ@@._V1._SX214_CR0,0,214,314_.jpg",2003,coffee_and_cigarettes,6.2,118,75,43,63,6.2,36,25,11,69,3.5,10991,75,http://content6.flixster.com/movie/99/21/85/9921852_det.jpg,-12
61724,Varjoja paratiisissa,92149,Sombras en el paraíso,"http://ia.media-imdb.com/images/M/MV5BMTIxODU5Mjk0Ml5BMl5BanBnXkFtZTcwMTMzNDMzMQ@@._V1._SY314_CR3,0,214,314_.jpg",1986,shadows_in_paradise,0,1,1,0,100,0,0,0,0,0,0,0,0,http://content7.flixster.com/movie/10/84/00/10840065_det.jpg,100
5109,Return to Never Land,280030,Peter Pan en regreso al país de Nunca Jamás,"http://ia.media-imdb.com/images/M/MV5BODI5MTk1MDM3N15BMl5BanBnXkFtZTcwNzM1MjI1MQ@@._V1._SY314_CR5,0,214,314_.jpg",2002,return_to_never_land,5.4,89,41,48,46,6.3,22,15,7,68,3.2,4974,54,http://content7.flixster.com/movie/23/30/99/2330993_det.jpg,-8
3156,Bicentennial Man,182789,El hombre bicentenario,"http://ia.media-imdb.com/images/M/MV5BMTM0MTE2NTgzMl5BMl5BanBnXkFtZTcwMDcyMTMyMQ@@._V1._SY314_CR3,0,214,314_.jpg",1999,bicentennial_man,4.8,93,35,58,37,4.6,23,6,17,26,3,22610,58,http://content7.flixster.com/movie/25/65/256509_det.jpg,-21
7896,Ride the High Country,56412,Duelo en la alta sierra,"http://ia.media-imdb.com/images/M/MV5BMTIxNjc4NjQ5MF5BMl5BanBnXkFtZTcwNjA0OTEzMQ@@._V1._SY314_CR27,0,214,314_.jpg",1962,ride_the_high_country,8.2,14,13,1,92,0,1,1,0,100,0,0,0,http://content7.flixster.com/movie/10/86/72/10867229_det.jpg,92
3399,Sesame Street Presents: Follow that Bird,89994,Sesame Street Presents: Follow that Bird,"http://ia.media-imdb.com/images/M/MV5BMTg4MDEzOTkwMV5BMl5BanBnXkFtZTYwMjY4OTg5._V1._SX214_CR0,0,214,314_.jpg",1985,sesame_street_presents_follow_that_bird,6.1,11,10,1,90,0,1,1,0,100,3.4,1485,64,http://content8.flixster.com/movie/10/92/47/10924766_det.jpg,26
6051,The Harder They Come,70155,Caiga quien caiga,"http://ia.media-imdb.com/images/M/MV5BMTI0NDYxMTMyNV5BMl5BanBnXkFtZTcwNzAzNzQzMQ@@._V1._SX214_CR0,0,214,314_.jpg",1972,harder_they_come,7.6,13,11,2,84,0,1,0,1,0,3.9,1321,84,http://content9.flixster.com/movie/31/31/313103_det.jpg,0
54290,Bratz,804452,Bratz,"http://ia.media-imdb.com/images/M/MV5BMTgxNzUzNTIwOV5BMl5BanBnXkFtZTcwMDk4MDU1MQ@@._V1._SY314_CR3,0,214,314_.jpg",2007,bratz_the_movie,2.9,71,5,66,7,3.2,23,2,21,8,3,27511,51,http://content7.flixster.com/movie/89/45/26/8945261_det.jpg,-44
19,Ace Ventura: When Nature Calls,112281,"Ace Ventura, operación África","http://ia.media-imdb.com/images/M/MV5BMjA0NTc4OTk1Ml5BMl5BanBnXkFtZTcwNjA0NTQzMQ@@._V1._SY314_CR17,0,214,314_.jpg",1995,ace_ventura_when_nature_calls,4.1,25,9,16,36,0,3,1,2,33,3.2,87306,73,http://content7.flixster.com/movie/10/94/18/10941853_det.jpg,-37
7739,Virtual Sexuality,164221,Sexualidad virtual,"http://ia.media-imdb.com/images/M/MV5BMTMzNTYyMTc3Nl5BMl5BanBnXkFtZTcwMjk2MzAzMQ@@._V1._SY314_CR4,0,214,314_.jpg",1999,virtual_sexuality,0,4,1,3,25,0,0,0,0,0,0,0,0,http://content6.flixster.com/movie/10/94/29/10942940_det.jpg,25
2804,A Christmas Story,85334,Historias de Navidad,"http://ia.media-imdb.com/images/M/MV5BMjEwMzI0NjY5NF5BMl5BanBnXkFtZTcwMzYyMjAwMg@@._V1._SY314_CR35,0,214,314_.jpg",1983,1004151-christmas_story,8.3,43,38,5,88,0,3,2,1,66,3.7,23109,82,http://content6.flixster.com/movie/10/93/70/10937040_det.jpg,6
27193,Taxi 2,183869,Taxi 2,"http://ia.media-imdb.com/images/M/MV5BMTgwMzAzMTMxOV5BMl5BanBnXkFtZTYwMzAwMzg5._V1._SY302_CR1,0,214,302_.jpg",2000,taxi_2,0,3,2,1,66,0,0,0,0,0,0,0,0,http://content9.flixster.com/movie/25/72/46/2572467_det.jpg,66
7313,Fire Birds,99575,Pájaros de fuego,"http://ia.media-imdb.com/images/M/MV5BMjE2MTM1NjM1MF5BMl5BanBnXkFtZTcwOTA0NzQyMQ@@._V1._SY314_CR2,0,214,314_.jpg",1990,fire_birds,3.1,15,1,14,6,0,4,0,4,0,2.9,1449,41,http://content7.flixster.com/movie/10/92/06/10920617_det.jpg,-35
8678,Guns of the Magnificent Seven,64395,La furia de los siete magnificos,"http://ia.media-imdb.com/images/M/MV5BMTIwNzA2MDQ1NV5BMl5BanBnXkFtZTcwMDY2OTAyMQ@@._V1._SX214_CR0,0,214,314_.jpg",1969,guns_of_the_magnificent_seven,0,2,2,0,100,0,0,0,0,0,0,0,0,http://content7.flixster.com/movie/10/92/05/10920549_det.jpg,100
5563,City by the Sea,269095,Condenado,"http://ia.media-imdb.com/images/M/MV5BMTYyNzg5OTcwNV5BMl5BanBnXkFtZTYwNDkxNDg5._V1._SY314_CR1,0,214,314_.jpg",2002,city_by_the_sea,5.8,140,67,73,47,5.8,33,17,16,51,2.9,3070,41,http://content7.flixster.com/movie/27/75/277501_det.jpg,6
47894,The Wind That Shakes the Barley,460989,El viento que agita la cebada,"http://ia.media-imdb.com/images/M/MV5BMTc1MjA5ODY2Ml5BMl5BanBnXkFtZTcwMTk2MTQ1MQ@@._V1._SY314_CR2,0,214,314_.jpg",2006,wind_that_shakes_the_barley,7.6,111,98,13,88,7.3,26,23,3,88,4,12108,86,http://content6.flixster.com/movie/10/84/04/10840436_det.jpg,2
7707,"He Said, She Said",102011,"Él dijo, ella dijo","http://ia.media-imdb.com/images/M/MV5BMTI1MjMxMTc5MV5BMl5BanBnXkFtZTcwNTU5ODIyMQ@@._V1._SY314_CR2,0,214,314_.jpg",1991,he_said_she_said,4.9,14,5,9,35,0,2,0,2,0,2.7,1214,33,http://content6.flixster.com/movie/10/84/58/10845848_det.jpg,2
32060,The Cat and the Canary,17739,El legado tenebroso,"http://ia.media-imdb.com/images/M/MV5BMTI5MzIwMzU5NV5BMl5BanBnXkFtZTcwMzM0NjcyMQ@@._V1._SY314_CR4,0,214,314_.jpg",1927,1003747-cat_and_the_canary,6.9,6,5,1,83,0,0,0,0,0,0,0,0,http://content6.flixster.com/movie/31/11/311196_det.jpg,83
4628,New York Stories,97965,Historias de Nueva York,"http://ia.media-imdb.com/images/M/MV5BMTQ0ODY1NjE0M15BMl5BanBnXkFtZTcwMzQ1MTYyMQ@@._V1._SY281_CR1,0,214,281_.jpg",1989,new_york_stories,6.1,23,17,6,73,6.4,5,3,2,60,3.4,3295,57,http://content6.flixster.com/movie/26/11/261108_det.jpg,16
2372,Fletch Lives,97366,Fletch Lives,"http://ia.media-imdb.com/images/M/MV5BMjAwNzQ1ODU3OV5BMl5BanBnXkFtZTcwNjE0MjAyMQ@@._V1._SY314_CR7,0,214,314_.jpg",1989,fletch_lives,4.1,13,4,9,30,0,1,0,1,0,2.9,2636,53,http://content6.flixster.com/movie/10/22/09/10220968_det.jpg,-23
2373,Red Sonja,800175,Red Sonja,"http://ia.media-imdb.com/images/M/MV5BMTU2OTQ3MjUwNF5BMl5BanBnXkFtZTcwMzA3MTA4MQ@@._V1._SX214_CR0,0,214,314_.jpg",2011,1200704-red_sonja,0,0,0,0,0,0,0,0,0,0,0,0,0,http://content6.flixster.com/movie/10/89/27/10892708_det.jpg,0
961,Little Lord Fauntleroy,27893,El pequeño Lord,"http://ia.media-imdb.com/images/M/MV5BNTQ5ODg0MTM1Ml5BMl5BanBnXkFtZTcwMjMxMDAyMQ@@._V1._SY314_CR1,0,214,314_.jpg",1936,1012439-little_lord_fauntleroy,7,5,4,1,80,0,0,0,0,0,0,0,0,http://content9.flixster.com/movie/49/60/85/4960855_det.jpg,80
6542,Kukushka,308476,Kukushka,"http://ia.media-imdb.com/images/M/MV5BNjQxMzI5MDE3MV5BMl5BanBnXkFtZTcwMDE1NTQyMQ@@._V1._SY314_CR2,0,214,314_.jpg",2002,cuckoo,7,62,54,8,87,7.2,23,21,2,91,4,791,87,http://content6.flixster.com/movie/26/12/261216_det.jpg,0
1816,Two Girls and a Guy,124179,Two Girls and a Guy,"http://ia.media-imdb.com/images/M/MV5BMTQ1MDIzNjMzMV5BMl5BanBnXkFtZTcwNTY0NDkxMQ@@._V1._SY314_CR4,0,214,314_.jpg",1997,two_girls_and_a_guy,5.6,57,30,27,52,6.4,18,10,8,55,2.8,1292,42,http://content7.flixster.com/movie/27/64/276425_det.jpg,10
2360,Festen,154420,Celebración,"http://ia.media-imdb.com/images/M/MV5BMjkwMjg0MzExMV5BMl5BanBnXkFtZTcwMDA0NzgyMQ@@._V1._SY314_CR3,0,214,314_.jpg",1998,1094723-celebration,8,36,33,3,91,8.3,5,5,0,100,4.3,5434,95,http://content7.flixster.com/movie/28/06/35/2806353_det.jpg,-4
55071,No End in Sight,912593,No End in Sight,http://ia.media-imdb.com/images/M/MV5BMjA2NzY2MzM2Ml5BMl5BanBnXkFtZTcwMzExMTU1MQ@@._V1._SX200_SY285_.jpg,2007,no_end_in_sight,8.1,91,86,5,94,8.2,25,24,1,96,4.3,4168,93,http://content7.flixster.com/movie/10/88/64/10886413_det.jpg,1
6849,Scrooge,66344,"Muchas gracias, Mr. Scrooge","http://ia.media-imdb.com/images/M/MV5BMTk3NTMyNTU3MV5BMl5BanBnXkFtZTcwODU3MDcyMQ@@._V1._SY314_CR3,0,214,314_.jpg",1970,1018413-scrooge,6.8,16,11,5,68,0,3,2,1,66,3.4,1834,72,http://content9.flixster.com/movie/25/08/250823_det.jpg,-4
39231,Elizabethtown,368709,Elizabethtown,"http://ia.media-imdb.com/images/M/MV5BMTcyNDcwNjcwMV5BMl5BanBnXkFtZTcwNzc3MzIzMQ@@._V1._SY314_CR4,0,214,314_.jpg",2005,elizabethtown,4.6,168,46,122,27,4.1,36,7,29,19,3.1,42584,65,http://content9.flixster.com/movie/25/03/250315_det.jpg,-38
6673,"¡Ay, Carmela!",101025,"¡Ay, Carmela!","http://ia.media-imdb.com/images/M/MV5BMTU0NjAyNjg5NF5BMl5BanBnXkFtZTcwNDYxOTI0MQ@@._V1._SY314_CR4,0,214,314_.jpg",1990,ay_carmela,0,2,1,1,50,0,0,0,0,0,0,0,0,http://content6.flixster.com/movie/10/84/10/10841000_det.jpg,50
2097,Something Wicked This Way Comes,86336,Something Wicked This Way Comes,"http://ia.media-imdb.com/images/M/MV5BMTA0MjA3NTExOTheQTJeQWpwZ15BbWU3MDM1NzU2MjE@._V1._SY314_CR2,0,214,314_.jpg",1983,something_wicked_this_way_comes,6.1,23,13,10,56,0,4,3,1,75,3.4,2097,64,http://content9.flixster.com/movie/26/58/265895_det.jpg,-8
48741,The U.S. vs. John Lennon,478049,The U.S. vs. John Lennon,"http://ia.media-imdb.com/images/M/MV5BMTA5ODIzNzAxNDVeQTJeQWpwZ15BbWU3MDUwODQ0MzE@._V1._SX214_CR0,0,214,314_.jpg",2006,us_vs_john_lennon,6.6,94,72,22,76,6.5,29,20,9,68,3.6,8813,70,http://content6.flixster.com/movie/25/04/33/2504336_det.jpg,6
549,Thirty Two Short Films About Glenn Gould,108328,Sinfonía en soledad: un retrato de Glenn Gould,"http://ia.media-imdb.com/images/M/MV5BMjA4MTA3NjI0N15BMl5BanBnXkFtZTcwMzUxOTAwMQ@@._V1._SY314_CR1,0,214,314_.jpg",1993,thirty-two-short-films-about-glenn-gould,8,17,15,2,88,0,3,3,0,100,3.8,1129,79,http://content6.flixster.com/movie/11/13/76/11137636_det.jpg,9
26136,The Hallelujah Trail,59250,La batalla de las Colinas del Whisky,"http://ia.media-imdb.com/images/M/MV5BMTIwMDc0ODE2OF5BMl5BanBnXkFtZTcwMDgyOTQyMQ@@._V1._SY314_CR2,0,214,314_.jpg",1965,hallelujah_trail,0,3,2,1,66,0,0,0,0,0,0,0,0,http://content9.flixster.com/movie/28/64/286411_det.jpg,66
1603,Mimic,119675,Mimic,"http://ia.media-imdb.com/images/M/MV5BMTIxMTQ4OTk5M15BMl5BanBnXkFtZTcwNDk2NjMyMQ@@._V1._SY314_CR8,0,214,314_.jpg",1997,mimic,6.3,30,17,13,56,6.3,6,3,3,50,2.7,5478,37,http://content9.flixster.com/movie/55/37/43/5537439_det.jpg,19
4273,Sous le sable,240913,Bajo la arena,"http://ia.media-imdb.com/images/M/MV5BMjAwMTI5OTg3Nl5BMl5BanBnXkFtZTcwNTY3OTUxMQ@@._V1._SY314_CR4,0,214,314_.jpg",2000,under_the_sand,7.5,70,66,4,94,7.8,23,23,0,100,3.7,924,79,http://content6.flixster.com/movie/10/88/93/10889300_det.jpg,15
679,The Run of the Country,114307,Una razón para luchar,"http://ia.media-imdb.com/images/M/MV5BNTY1MTk2MjIxOV5BMl5BanBnXkFtZTcwNjI2MzMyMQ@@._V1._SX214_CR0,0,214,314_.jpg",1995,run_of_the_country,6,7,3,4,42,0,2,1,1,50,3.3,237,60,http://content8.flixster.com/movie/31/34/313418_det.jpg,-18
8851,Smile,397103,Smile,"http://ia.media-imdb.com/images/M/MV5BMTcxMDY1NTg3Ml5BMl5BanBnXkFtZTcwMjU0OTcyMQ@@._V1._SY314_CR15,0,214,314_.jpg",2005,10005057-smile,4,13,2,11,15,3.9,5,1,4,20,3.5,585,69,http://content9.flixster.com/movie/10/87/99/10879935_det.jpg,-54
1792,U.S. Marshals,120873,U.S. Marshals,"http://ia.media-imdb.com/images/M/MV5BMjEyMDk3NjgxM15BMl5BanBnXkFtZTcwOTU4MTYyMQ@@._V1._SY216_CR37,0,214,216_.jpg",1998,us_marshals,4.9,30,8,22,26,5,7,1,6,14,3.2,12491,59,http://content7.flixster.com/movie/11/14/00/11140001_det.jpg,-33
2738,Crimes of the Heart,90886,Crímenes del corazón,"http://ia.media-imdb.com/images/M/MV5BMTI4NDM5OTMzNV5BMl5BanBnXkFtZTcwNjM4MDUyMQ@@._V1._SY314_CR4,0,214,314_.jpg",1986,crimes_of_the_heart,7.6,14,14,0,100,0,1,1,0,100,3.3,602,53,http://content9.flixster.com/movie/25/87/258799_det.jpg,47
61634,Son of Lassie,38097,El cachorro de Lassie,"http://ia.media-imdb.com/images/M/MV5BMTI3MzE5MzYxNl5BMl5BanBnXkFtZTcwMTE3OTUyMQ@@._V1._SY314_CR21,0,214,314_.jpg",1945,son_of_lassie,0,3,2,1,66,0,0,0,0,0,0,0,0,http://content9.flixster.com/movie/92/24/67/9224679_det.jpg,66
2773,Alice et Martin,176422,Alice y Martin,http://ia.media-imdb.com/images/M/MV5BMTU0MDUxODc2MV5BMl5BanBnXkFtZTcwMDI2NzkxMQ@@._V1._SX76_SY140_.jpg,1998,alice-et-martin-alice-and-martin,6.3,42,26,16,61,6.6,13,10,3,76,3.4,246,51,http://content7.flixster.com/movie/10/14/06/10140645_det.jpg,10
3208,Loaded Weapon 1,107659,Con el arma a punto,"http://ia.media-imdb.com/images/M/MV5BMTQ3ODIzOTcyOV5BMl5BanBnXkFtZTcwMzA2ODYyMQ@@._V1._SY314_CR9,0,214,314_.jpg",1993,national_lampoons_loaded_weapon_1,3.5,22,3,19,13,0,4,0,4,0,2.8,4689,50,http://content6.flixster.com/movie/10/88/28/10882800_det.jpg,-37
1329,Blood for Dracula,71233,Blood for Dracula,"http://ia.media-imdb.com/images/M/MV5BMTg0MTg5MTk0Nl5BMl5BanBnXkFtZTcwOTkzMTQyMQ@@._V1._SY312_CR1,0,214,312_.jpg",1974,blood-for-dracula,6.4,15,10,5,66,0,2,1,1,50,3.4,1432,58,http://content6.flixster.com/movie/10/91/36/10913628_det.jpg,8
7455,The Mudge Boy,339419,The Mudge Boy,http://ia.media-imdb.com/images/M/MV5BMTM0MjU1OTY0OV5BMl5BanBnXkFtZTcwMTU1ODUyMQ@@._V1._SX159_SY224_.jpg,2003,mudge_boy,6.4,26,20,6,76,6.4,13,10,3,76,3.7,728,73,http://content8.flixster.com/movie/43/59/19/4359190_det.jpg,3
5650,The Adventures of Bob & Doug McKenzie: Strange Brew,86373,The Adventures of Bob & Doug McKenzie: Strange Brew,"http://ia.media-imdb.com/images/M/MV5BMjE0MTI4OTQzOF5BMl5BanBnXkFtZTcwOTg0MzMyMQ@@._V1._SY314_CR1,0,214,314_.jpg",1983,strange_brew,6.5,20,14,6,70,0,1,0,1,0,3.4,4156,80,http://content9.flixster.com/movie/25/50/255023_det.jpg,-10
1822,Meet the Deedles,120645,Vaya par de idiotas,"http://ia.media-imdb.com/images/M/MV5BMTI4NDQ1NjMyNV5BMl5BanBnXkFtZTYwMTM0NjM5._V1._SY314_CR12,0,214,314_.jpg",1998,meet_the_deedles,2.4,26,1,25,3,3,5,0,5,0,2.6,1774,39,http://content9.flixster.com/movie/10/88/97/10889707_det.jpg,-36
6526,Hachi-gatsu no kyôshikyoku,101991,Hachi-gatsu no kyôshikyoku,"http://ia.media-imdb.com/images/M/MV5BMTg3OTA5MzA0NF5BMl5BanBnXkFtZTcwNjY2MTYyMQ@@._V1._SX214_CR0,0,214,314_.jpg",1991,rhapsody-in-august,5.8,8,5,3,62,5.6,5,3,2,60,3.6,1375,73,http://content8.flixster.com/movie/26/16/261602_det.jpg,-11
4677,Turner & Hooch,98536,Socios y sabuesos,"http://ia.media-imdb.com/images/M/MV5BMTA1MzMxODQ0MzleQTJeQWpwZ15BbWU3MDI4NDM0MjE@._V1._SY314_CR2,0,214,314_.jpg",1989,turner_and_hooch,5.2,21,13,8,61,0,0,0,0,0,0,0,0,http://content6.flixster.com/movie/25/66/256616_det.jpg,61
6249,Boat Trip,285462,Boat Trip,"http://ia.media-imdb.com/images/M/MV5BNDQ5NDMxOTk2OV5BMl5BanBnXkFtZTcwNjE1MzAwMQ@@._V1._SY314_CR7,0,214,314_.jpg",2002,boat_trip,2.6,87,6,81,6,3,22,2,20,9,2.7,8176,44,http://content7.flixster.com/movie/10/92/18/10921881_det.jpg,-38
32213,Cube Zero,377713,Cube Zero,"http://ia.media-imdb.com/images/M/MV5BMTM4OTUyNzgxOF5BMl5BanBnXkFtZTcwMDQ4NjcyMQ@@._V1._SY314_CR0,0,214,314_.jpg",2004,1139738-cube_zero,0,3,3,0,100,0,0,0,0,0,0,0,0,http://content9.flixster.com/movie/27/08/270891_det.jpg,100
5405,Dakota,37627,Dakota,"http://ia.media-imdb.com/images/M/MV5BMjEzNzE5NDgwNV5BMl5BanBnXkFtZTcwMTE0NDgxMQ@@._V1._SX214_CR0,0,214,314_.jpg",1945,1005131-dakota,0,2,0,2,0,0,0,0,0,0,0,0,0,http://content9.flixster.com/movie/10/89/16/10891627_det.jpg,0
43932,Pulse,454919,Conexión,"http://ia.media-imdb.com/images/M/MV5BMTMyOTg5MjY1OF5BMl5BanBnXkFtZTcwNTM1ODYzMQ@@._V1._SX214_CR0,0,214,314_.jpg",2006,pulse,3.5,66,7,59,10,3.1,19,1,18,5,2.7,30788,38,http://content8.flixster.com/movie/78/63/786390_det.jpg,-28
6875,Dopamine,342300,Dopamine,"http://ia.media-imdb.com/images/M/MV5BMTg1NzMzMDQwNV5BMl5BanBnXkFtZTcwODQyNjAwMQ@@._V1._SY314_CR0,0,214,314_.jpg",2003,dopamine,5.5,51,26,25,50,5.4,20,8,12,40,3.1,357,51,http://content7.flixster.com/movie/28/15/281525_det.jpg,-1
7675,The Canterville Ghost,115820,The Canterville Ghost,"http://ia.media-imdb.com/images/M/MV5BMTI2Njk5MjY3M15BMl5BanBnXkFtZTcwNzIyMzYxMQ@@._V1._SY314_CR4,0,214,314_.jpg",1996,1067316-canterville_ghost,0,0,0,0,0,0,0,0,0,0,0,0,0,http://content9.flixster.com/movie/10/86/26/10862627_det.jpg,0
2652,The Curse of Frankenstein,50280,La maldición de Frankenstein,"http://ia.media-imdb.com/images/M/MV5BOTU0NTA5Nzk5OF5BMl5BanBnXkFtZTcwNzY1ODgxMQ@@._V1._SY314_CR8,0,214,314_.jpg",1957,curse_of_frankenstein,7.6,7,7,0,100,0,0,0,0,0,0,0,0,http://content8.flixster.com/movie/30/20/302002_det.jpg,100
968,Night of the Living Dead,63350,La noche de los muertos vivientes,"http://ia.media-imdb.com/images/M/MV5BMjE1OTI5MDE4NF5BMl5BanBnXkFtZTYwMDI4Njk4._V1._SX214_CR0,0,214,314_.jpg",1968,1015052-night_of_the_living_dead,8.5,45,43,2,95,7,5,4,1,80,3.7,26113,85,http://content6.flixster.com/movie/10/91/62/10916208_det.jpg,10
1324,Amityville: Dollhouse,115535,Amityville: Dollhouse,"http://ia.media-imdb.com/images/M/MV5BMTIwOTg1ODE5MV5BMl5BanBnXkFtZTcwNTczNjcyMQ@@._V1._SY314_CR5,0,214,314_.jpg",1996,amityville_dollhouse,0,2,0,2,0,0,0,0,0,0,0,0,0,http://content9.flixster.com/movie/27/32/273299_det.jpg,0
6978,Slackers,240900,Slackers,"http://ia.media-imdb.com/images/M/MV5BMTQ3OTYzNDA1NV5BMl5BanBnXkFtZTcwNTEyODEyMQ@@._V1._SY314_CR4,0,214,314_.jpg",2002,slackers,3.1,104,11,93,10,2.4,30,1,29,3,2.8,4294,52,http://content6.flixster.com/movie/10/93/77/10937732_det.jpg,-42
64918,Petites coupures,304547,Petites coupures,"http://ia.media-imdb.com/images/M/MV5BMjkzNzI3NTcxOF5BMl5BanBnXkFtZTcwMzA2MTYyMQ@@._V1._SY229_CR44,0,214,229_.jpg",2003,petites_coupures,0,4,2,2,50,0,0,0,0,0,0,0,0,http://content8.flixster.com/movie/10/85/34/10853430_det.jpg,50
78,The Crossing Guard,112744,Cruzando la oscuridad,"http://ia.media-imdb.com/images/M/MV5BMTQ4NDM4MTA0Nl5BMl5BanBnXkFtZTcwNzkxMjEyMQ@@._V1._SY314_CR1,0,214,314_.jpg",1995,crossing_guard,6.5,27,20,7,74,0,4,2,2,50,3.3,2170,56,http://content7.flixster.com/movie/27/69/276905_det.jpg,18
3083,Todo sobre mi madre,185125,Todo sobre mi madre,"http://ia.media-imdb.com/images/M/MV5BMjE3OTg3MTk2NV5BMl5BanBnXkFtZTcwNzA4ODMyMQ@@._V1._SX214_CR0,0,214,314_.jpg",1999,all_about_my_mother,8,80,78,2,97,8,23,22,1,95,4.2,16912,93,http://content7.flixster.com/movie/10/95/09/10950921_det.jpg,4
5443,Juwanna Mann,247444,Juwanna Mann,"http://ia.media-imdb.com/images/M/MV5BMjE3Mzc0NTExMF5BMl5BanBnXkFtZTcwNjIwODkxMQ@@._V1._SY314_CR2,0,214,314_.jpg",2002,juwanna_mann,3.2,82,7,75,8,3.2,24,2,22,8,2.5,1219,46,http://content6.flixster.com/movie/26/32/263228_det.jpg,-38
32151,It Happened to Jane,52933,La indómita y el millonario,"http://ia.media-imdb.com/images/M/MV5BMTQwMjczODc4N15BMl5BanBnXkFtZTcwMDA1OTcyMQ@@._V1._SY314_CR0,0,214,314_.jpg",1959,it_happened_to_jane,0,2,0,2,0,0,0,0,0,0,0,0,0,http://content8.flixster.com/movie/10/90/04/10900486_det.jpg,0
5780,Polyester,82926,Polyester,"http://ia.media-imdb.com/images/M/MV5BMTMzODAwMzM4OF5BMl5BanBnXkFtZTcwMDc2MTQyMQ@@._V1._SY216_CR35,0,214,216_.jpg",1981,polyester,7.1,17,15,2,88,0,0,0,0,0,0,0,0,http://content8.flixster.com/movie/95/83/91/9583918_det.jpg,88
3108,The Fisher King,101889,El rey pescador,http://ia.media-imdb.com/images/M/MV5BMTYwODc3NjQ4OF5BMl5BanBnXkFtZTcwNTMxMjQyMQ@@._V1._SX99_SY140_.jpg,1991,fisher_king,7,50,43,7,86,6.8,8,6,2,75,3.6,8960,83,http://content6.flixster.com/movie/26/82/268204_det.jpg,3
5785,Jackass: The Movie,322802,Jackass: The Movie,"http://ia.media-imdb.com/images/M/MV5BMTkwNTM5ODczOV5BMl5BanBnXkFtZTcwODk3MzUzMQ@@._V1._SY314_CR5,0,214,314_.jpg",2002,jackass_the_movie,5.1,93,46,47,49,4.1,17,6,11,35,3.4,50664,78,http://content6.flixster.com/movie/26/98/269808_det.jpg,-29
4370,Artificial Intelligence: AI,212720,A.I. Inteligencia Artificial,"http://ia.media-imdb.com/images/M/MV5BMTIwNzMwNDY2NV5BMl5BanBnXkFtZTYwMzgxNjY5._V1._SX214_CR0,0,214,314_.jpg",2001,ai_artificial_intelligence,6.6,186,135,51,72,6.4,40,27,13,67,3.1,42316,58,http://content7.flixster.com/movie/10/86/76/10867613_det.jpg,14
4379,"South of Heaven, West of Hell",179473,"South of Heaven, West of Hell","http://ia.media-imdb.com/images/M/MV5BNDczNDg4NDM4OV5BMl5BanBnXkFtZTcwNDU2ODEyMQ@@._V1._SX214_CR0,0,214,314_.jpg",2000,south_of_heaven_west_of_hell,3.5,7,1,6,14,0,0,0,0,0,0,0,0,http://content7.flixster.com/movie/41/69/15/4169153_det.jpg,14
32291,Melinda and Melinda,378947,Melinda y Melinda,http://ia.media-imdb.com/images/M/MV5BMTg0NzY4Nzc1MF5BMl5BanBnXkFtZTcwMzA3NzUzMQ@@._V1._SX144_SY203_.jpg,2004,melinda_and_melinda,5.8,154,82,72,53,6,39,22,17,56,3.1,2565,45,http://content7.flixster.com/movie/10/92/26/10922673_det.jpg,8
55391,10th & Wolf,360323,10th & Wolf,"http://ia.media-imdb.com/images/M/MV5BMjE1NDE0Nzk3MV5BMl5BanBnXkFtZTcwMjE3ODQzMQ@@._V1._SY314_CR2,0,214,314_.jpg",2006,10th_and_wolf,4,27,5,22,18,3.5,10,1,9,10,3.1,9910,44,http://content7.flixster.com/movie/21/37/16/2137169_det.jpg,-26
48593,Man of the Year,483726,Man of the Year,"http://ia.media-imdb.com/images/M/MV5BMTM0NzQxMjk0OV5BMl5BanBnXkFtZTcwMDUyNDgzMQ@@._V1._SX214_CR0,0,214,314_.jpg",2006,man_of_the_year,4.4,141,30,111,21,5,35,11,24,31,3,29127,51,http://content9.flixster.com/movie/11/12/89/11128939_det.jpg,-30
63676,Tanin no kao,61065,Tanin no kao,"http://ia.media-imdb.com/images/M/MV5BMTk3OTkzMDE0OV5BMl5BanBnXkFtZTcwMzEzNjk0MQ@@._V1._SY314_CR4,0,214,314_.jpg",1966,face_of_another,7.4,6,6,0,100,0,1,1,0,100,4.1,598,90,http://content8.flixster.com/movie/93/50/55/9350550_det.jpg,10
4386,The Truth About Cats & Dogs,117979,La verdad sobre perros y gatos,"http://ia.media-imdb.com/images/M/MV5BMTI5ODI4NTIxNl5BMl5BanBnXkFtZTcwOTU5MzEyMQ@@._V1._SY314_CR1,0,214,314_.jpg",1996,truth_about_cats_and_dogs,6.7,36,30,6,83,7.6,6,5,1,83,2.9,6120,55,http://content9.flixster.com/movie/10/88/92/10889235_det.jpg,28
2131,Höstsonaten,77711,Sonata de otoño,"http://ia.media-imdb.com/images/M/MV5BNTMzMTQyOTUxMF5BMl5BanBnXkFtZTcwMzE5NDkxMQ@@._V1._SY314_CR5,0,214,314_.jpg",1978,autumn_sonata,8,19,18,1,94,0,1,1,0,100,4.1,2226,90,http://content7.flixster.com/movie/26/49/264925_det.jpg,4
7645,Iron & Silk,99857,Iron & Silk,"http://ia.media-imdb.com/images/M/MV5BMjE2OTI2MDU0MF5BMl5BanBnXkFtZTcwNDM1MzcyMQ@@._V1._SY314_CR3,0,214,314_.jpg",1990,iron_and_silk,6.3,5,4,1,80,0,0,0,0,0,0,0,0,http://content7.flixster.com/movie/10/96/28/10962869_det.jpg,80
6709,Once Upon a Time in Mexico,285823,El mexicano (Once upon a time in Mexico),"http://ia.media-imdb.com/images/M/MV5BMTU5MDg5OTcwOV5BMl5BanBnXkFtZTcwMjI1MTIzMw@@._V1._SX214_CR0,0,214,314_.jpg",2003,once_upon_a_time_in_mexico,6.3,159,108,51,67,6.3,33,22,11,66,3.2,31247,66,http://content9.flixster.com/movie/10/89/38/10893899_det.jpg,1
2507,Breakfast of Champions,120618,El desayuno de los campeones,"http://ia.media-imdb.com/images/M/MV5BMTU4MDU4NTkwOF5BMl5BanBnXkFtZTcwNjAzNTUyMQ@@._V1._SY314_CR3,0,214,314_.jpg",1999,breakfast_of_champions,4.2,44,11,33,25,3.4,13,1,12,7,2.5,1509,31,http://content6.flixster.com/movie/10/88/32/10883264_det.jpg,-6
5294,Frailty,264616,Escalofrío,"http://ia.media-imdb.com/images/M/MV5BMTUwMDcyNDUwOF5BMl5BanBnXkFtZTcwNjAzODMyMQ@@._V1._SY314_CR4,0,214,314_.jpg",2001,frailty,6.9,133,98,35,73,6.6,31,22,9,70,3.5,8605,78,http://content6.flixster.com/movie/26/90/269096_det.jpg,-5
525,The Saint of Fort Washington,108026,Ángeles sin cielo,http://ia.media-imdb.com/images/M/MV5BMTk2ODQ0MzM5M15BMl5BanBnXkFtZTcwNDMyMjQyMQ@@._V1._SX80_SY140_.jpg,1993,saint_of_fort_washington,6.5,9,6,3,66,0,3,2,1,66,3.9,305,84,http://content8.flixster.com/movie/10/86/88/10868814_det.jpg,-18
1067,A Damsel in Distress,28757,Señorita en desgracia,"http://ia.media-imdb.com/images/M/MV5BMTQyODIxMzM2Ml5BMl5BanBnXkFtZTcwMzMxMDcxMQ@@._V1._SX214_CR0,0,214,314_.jpg",1937,damsel_in_distress,0,4,3,1,75,0,1,1,0,100,3.5,179,59,http://content9.flixster.com/movie/10/87/43/10874351_det.jpg,16
8760,Side Out,100613,Los reyes de la playa,"http://ia.media-imdb.com/images/M/MV5BMTIzNDExNjY1Nl5BMl5BanBnXkFtZTcwNjg5NzUyMQ@@._V1._SY314_CR0,0,214,314_.jpg",1990,side_out,0,4,0,4,0,0,0,0,0,0,0,0,0,http://content9.flixster.com/movie/26/24/262491_det.jpg,0
4650,Relentless,98184,"Fuera de sí, sin descanso","http://ia.media-imdb.com/images/M/MV5BNjYwNjcxNDY3NF5BMl5BanBnXkFtZTcwNjcwODYyMQ@@._V1._SY314_CR0,0,214,314_.jpg",1989,relentless,0,4,1,3,25,0,0,0,0,0,0,0,0,http://content8.flixster.com/movie/10/93/72/10937266_det.jpg,25
211,The Browning Version,43362,The Browning Version,"http://ia.media-imdb.com/images/M/MV5BMTg1Mzk0MjY3MV5BMl5BanBnXkFtZTcwODExMTkyMQ@@._V1._SY314_CR4,0,214,314_.jpg",1951,1043923-browning_version,7.8,17,15,2,88,0,3,1,2,33,4.3,270,94,http://content7.flixster.com/movie/10/83/88/10838841_det.jpg,-6
2142,An American Tail: Fievel Goes West,101329,Fievel va al Oeste,"http://ia.media-imdb.com/images/M/MV5BMTYzODMxNTUyNF5BMl5BanBnXkFtZTcwMTAwMzQyMQ@@._V1._SX214_CR0,0,214,314_.jpg",1991,american_tail_fievel_goes_west,5.4,9,3,6,33,0,2,1,1,50,3.2,16427,58,http://content6.flixster.com/movie/25/31/253108_det.jpg,-25
27839,The Ring Two,377109,The ring two - La señal 2,"http://ia.media-imdb.com/images/M/MV5BMTY2ODc2NTQ2OF5BMl5BanBnXkFtZTYwNzA4OTU3._V1._SX214_CR0,0,214,314_.jpg",2005,ring_two,4.4,178,36,142,20,4.7,37,10,27,27,2.8,39779,54,http://content9.flixster.com/movie/10/86/94/10869455_det.jpg,-34
3661,Puppet Master II,100438,Puppet Master 2 - Muñecos asesinos,"http://ia.media-imdb.com/images/M/MV5BMTgwNDAwNjQ0NF5BMl5BanBnXkFtZTYwODcxNzYy._V1._SX32_CR0,0,32,44_.jpg",1991,puppet_master_2_his_unholy_creations,4.4,5,1,4,20,0,0,0,0,0,0,0,0,http://content7.flixster.com/movie/10/94/36/10943685_det.jpg,20
593,The Silence of the Lambs,102926,El silencio de los corderos,"http://ia.media-imdb.com/images/M/MV5BMTc2MjE2NzM2N15BMl5BanBnXkFtZTcwMjM3MjI3Mw@@._V1._SX214_CR0,0,214,314_.jpg",1991,silence_of_the_lambs,8.5,52,50,2,96,7.8,11,10,1,90,4,98921,93,http://content7.flixster.com/movie/55/12/86/5512865_det.jpg,3
5689,Billy Bathgate,101453,Billy Bathgate,"http://ia.media-imdb.com/images/M/MV5BMTQ4MjUxNjcwMF5BMl5BanBnXkFtZTcwNTU3OTMyMQ@@._V1._SY314_CR1,0,214,314_.jpg",1991,billy_bathgate,5.2,18,9,9,50,0,2,0,2,0,2.8,1397,32,http://content7.flixster.com/movie/27/24/272493_det.jpg,18
27873,Metallica: Some Kind of Monster,387412,Metallica: Some Kind of Monster,"http://ia.media-imdb.com/images/M/MV5BMTc3OTg4NzM1MF5BMl5BanBnXkFtZTcwNTM4NjcyMQ@@._V1._SY314_CR5,0,214,314_.jpg",2004,metallica_some_kind_of_monster,7.6,121,107,14,88,7.5,32,30,2,93,3.7,5021,83,http://content6.flixster.com/movie/26/84/268408_det.jpg,5
32596,Sahara,318649,Sahara,"http://ia.media-imdb.com/images/M/MV5BMjExOTM4NDUzNV5BMl5BanBnXkFtZTcwOTgzNzczMw@@._V1._SX214_CR0,0,214,314_.jpg",2005,1144274-sahara,5.2,171,66,105,38,5,34,15,19,44,3,24489,61,http://content6.flixster.com/movie/24/97/249732_det.jpg,-23
5826,Rio Grande,42895,Río Grande,"http://ia.media-imdb.com/images/M/MV5BMTY0NjI2MTYyMl5BMl5BanBnXkFtZTcwODQ0MTA0MQ@@._V1._SY314_CR4,0,214,314_.jpg",1950,rio_grande,6.7,12,9,3,75,0,0,0,0,0,0,0,0,http://content9.flixster.com/movie/30/10/301019_det.jpg,75
1482,Van Helsing,338526,Van Helsing,"http://ia.media-imdb.com/images/M/MV5BMTU1MTQzMTA4NV5BMl5BanBnXkFtZTcwNTA1NTYyMQ@@._V1._SY314_CR3,0,214,314_.jpg",2004,unhuman,0,0,0,0,0,0,0,0,0,0,0,0,0,http://content8.flixster.com/movie/10/84/54/10845422_det.jpg,0
228,Destiny Turns on the Radio,112854,Johnny Destiny,"http://ia.media-imdb.com/images/M/MV5BMTQzMDUwMDA0OF5BMl5BanBnXkFtZTYwNjY4NDg5._V1._SX214_CR0,0,214,314_.jpg",1995,destiny_turns_on_the_radio,2.7,15,2,13,13,0,2,0,2,0,2.6,446,27,http://content8.flixster.com/movie/71/21/48/7121486_det.jpg,-14
62439,My Best Friend's Girl,1046163,Una novia para dos,"http://ia.media-imdb.com/images/M/MV5BMTg4MDg5NjE3Nl5BMl5BanBnXkFtZTcwNzc4ODQ3MQ@@._V1._SX214_CR0,0,214,314_.jpg",2008,10008611-my_best_friends_girl,3.5,56,8,48,14,3.7,12,2,10,16,3.2,22662,52,http://content6.flixster.com/movie/10/92/18/10921856_det.jpg,-38
4653,The Return of the Musketeers,98194,El regreso de los mosqueteros,"http://ia.media-imdb.com/images/M/MV5BMTI3NDQ5OTQ3MF5BMl5BanBnXkFtZTYwNjU0OTg5._V1._SY216_CR46,0,214,216_.jpg",1989,the-return-of-the-musketeers,5.6,5,3,2,60,0,0,0,0,0,0,0,0,http://content6.flixster.com/movie/32/92/98/3292988_det.jpg,60
5053,Blankman,109288,"Blankman, mi hermano el chiflado","http://ia.media-imdb.com/images/M/MV5BMTQyNDc4OTA5OF5BMl5BanBnXkFtZTcwOTI1NzMyMQ@@._V1._SX214_CR0,0,214,314_.jpg",1994,blankman,3.3,15,2,13,13,0,3,1,2,33,2.3,2988,32,http://content6.flixster.com/movie/26/04/260492_det.jpg,-19
3474,Retroactive,117468,Retroactive,"http://ia.media-imdb.com/images/M/MV5BMTkxODIwNDA3Nl5BMl5BanBnXkFtZTcwNDEyNzUyMQ@@._V1._SX214_CR0,0,214,314_.jpg",1997,retroactive,4.4,5,2,3,40,0,0,0,0,0,0,0,0,http://content7.flixster.com/movie/28/19/281997_det.jpg,40
7270,Sleep with Me,111218,Duerme conmigo,"http://ia.media-imdb.com/images/M/MV5BMTc2OTg1MjgwNV5BMl5BanBnXkFtZTcwODE2NTQyMQ@@._V1._SY314_CR8,0,214,314_.jpg",1994,sleep_with_me,4.6,12,2,10,16,0,3,0,3,0,3.2,521,48,http://content9.flixster.com/movie/10/89/25/10892563_det.jpg,-32
3531,All the Vermeers in New York,99014,All the Vermeers in New York,"http://ia.media-imdb.com/images/M/MV5BMTI5NDExMjkzOF5BMl5BanBnXkFtZTcwMDgxMjIyMQ@@._V1._SY314_CR0,0,214,314_.jpg",1990,all_the_vermeers_in_new_york,7.2,5,5,0,100,0,1,1,0,100,3,232,49,http://content7.flixster.com/movie/28/96/289605_det.jpg,51
8571,Bob & Carol & Ted & Alice,64100,"Bob, Carol, Ted y Alice","http://ia.media-imdb.com/images/M/MV5BMTU5MDI3MjM0M15BMl5BanBnXkFtZTcwMDEzMTcyMQ@@._V1._SY314_CR2,0,214,314_.jpg",1969,bob_and_carol_and_ted_and_alice,7.4,9,8,1,88,0,1,1,0,100,3.4,516,62,http://content9.flixster.com/movie/78/46/17/7846171_det.jpg,26
3544,Shakes the Clown,102898,Shakes the Clown,"http://ia.media-imdb.com/images/M/MV5BMTkyMzkzMDYxNF5BMl5BanBnXkFtZTcwNjExNzMyMQ@@._V1._SX214_CR0,0,214,314_.jpg",1991,shakes_the_clown,4.4,19,7,12,36,0,2,0,2,0,0,0,0,http://content9.flixster.com/movie/21/00/16/2100167_det.jpg,36
428,A Bronx Tale,106489,Una historia del Bronx,"http://ia.media-imdb.com/images/M/MV5BMjUyMzIxMzQwN15BMl5BanBnXkFtZTcwNjM0MzAyMQ@@._V1._SY314_CR8,0,214,314_.jpg",1993,bronx_tale,7.4,26,25,1,96,0,3,3,0,100,3.9,17840,89,http://content7.flixster.com/movie/10/88/62/10886213_det.jpg,7
696,Butterfly Kiss,112604,Besos de mariposa,"http://ia.media-imdb.com/images/M/MV5BMTIyMzAzMDgyN15BMl5BanBnXkFtZTcwMjY3ODkxMQ@@._V1._SY314_CR4,0,214,314_.jpg",1995,butterfly_kiss,6.4,13,10,3,76,0,1,1,0,100,3.2,586,55,http://content8.flixster.com/movie/11/13/63/11136386_det.jpg,21
5552,The Revenge of Frankenstein,50894,The Revenge of Frankenstein,"http://ia.media-imdb.com/images/M/MV5BMTMyNTUyODk4OV5BMl5BanBnXkFtZTcwNTA4MTkyMQ@@._V1._SY314_CR0,0,214,314_.jpg",1958,revenge_of_frankenstein,6.2,7,6,1,85,0,0,0,0,0,0,0,0,http://content9.flixster.com/movie/28/78/287815_det.jpg,85
26934,Sik san,116426,Sik san,"http://ia.media-imdb.com/images/M/MV5BMTYzMDM0NzI0Ml5BMl5BanBnXkFtZTcwMTc3NDYxMQ@@._V1._SY314_CR8,0,214,314_.jpg",1996,god-of-cookery,0,3,3,0,100,0,0,0,0,0,0,0,0,http://content7.flixster.com/movie/11/13/01/11130145_det.jpg,100
5925,The Beast Within,83629,The Beast Within,http://ia.media-imdb.com/images/M/MV5BMjA4MjUzNjk0NF5BMl5BanBnXkFtZTcwNzk4MjYxMQ@@._V1._SX77_SY140_.jpg,1982,beast_within,0,4,0,4,0,0,0,0,0,0,0,0,0,http://content9.flixster.com/movie/10/91/95/10919519_det.jpg,0
4573,Blaze,96943,El escándalo Blaze,"http://ia.media-imdb.com/images/M/MV5BMjE2MDI2ODYxNF5BMl5BanBnXkFtZTcwMDI4NjUyMQ@@._V1._SY314_CR5,0,214,314_.jpg",1989,blaze,6.3,10,8,2,80,0,1,1,0,100,2.9,402,40,http://content7.flixster.com/movie/10/89/14/10891433_det.jpg,40
25,Leaving Las Vegas,113627,Leaving Las Vegas,"http://ia.media-imdb.com/images/M/MV5BMTIzOTEzMzQwNF5BMl5BanBnXkFtZTcwNjE0MTYyMQ@@._V1._SX214_CR0,0,214,314_.jpg",1995,leaving_las_vegas,7.7,45,40,5,88,8.1,11,11,0,100,3.6,12742,82,http://content7.flixster.com/movie/10/90/25/10902561_det.jpg,6
7843,Lammbock,258760,Lammbock,"http://ia.media-imdb.com/images/M/MV5BMjAzNzc3NjgwMV5BMl5BanBnXkFtZTcwNTAwMTAyMQ@@._V1._SY314_CR4,0,214,314_.jpg",2001,lammbock,0,0,0,0,0,0,0,0,0,0,0,0,0,http://content9.flixster.com/movie/10/85/44/10854467_det.jpg,0
3322,3 Strikes,199290,3 Strikes,"http://ia.media-imdb.com/images/M/MV5BMTIzOTU5NTIxMl5BMl5BanBnXkFtZTYwODM1Mzk5._V1._SY312_CR1,0,214,312_.jpg",2000,3_strikes,2.3,29,0,29,0,2.4,11,0,11,0,3.1,1088,60,http://content6.flixster.com/movie/27/52/275204_det.jpg,-60
5036,California Suite,77289,California Suite,"http://ia.media-imdb.com/images/M/MV5BMTY0NTI4NTExMV5BMl5BanBnXkFtZTcwNTc0MDYxMQ@@._V1._SY314_CR1,0,214,314_.jpg",1978,california_suite,5.2,19,11,8,57,0,2,0,2,0,3.1,671,47,http://content8.flixster.com/movie/26/28/262810_det.jpg,10
1057,Everyone Says I Love You,116242,Todos dicen I Love You,"http://ia.media-imdb.com/images/M/MV5BMTI2NjI1OTI5NF5BMl5BanBnXkFtZTcwMjI4MTUxMQ@@._V1._SY314_CR1,0,214,314_.jpg",1996,everyone_says_i_love_you,7.3,41,32,9,78,7,9,5,4,55,3.4,6964,63,http://content6.flixster.com/movie/10/89/31/10893116_det.jpg,15
25946,The Three Musketeers,108333,Los tres mosqueteros,"http://ia.media-imdb.com/images/M/MV5BMjExNzg2NTU3MV5BMl5BanBnXkFtZTYwMDY4MDk5._V1._SX214_CR0,0,214,314_.jpg",1993,1046772-three_musketeers,4.8,24,7,17,29,0,3,0,3,0,3.2,13783,67,http://content7.flixster.com/movie/50/26/53/5026533_det.jpg,-38
4903,In the Bedroom,247425,En la habitación,"http://ia.media-imdb.com/images/M/MV5BMTIzMDc5ODM2MV5BMl5BanBnXkFtZTYwNDU2NTg4._V1._SY314_CR4,0,214,314_.jpg",2001,in_the_bedroom,7.9,137,128,9,93,7.6,31,28,3,90,3.7,4252,79,http://content9.flixster.com/movie/27/07/270711_det.jpg,14
5935,Class of 1984,83739,Curso 1984,"http://ia.media-imdb.com/images/M/MV5BMTgzNDg2MzM3OF5BMl5BanBnXkFtZTYwMDM2Mjg5._V1._SX214_CR0,0,214,314_.jpg",1982,class_of_1984,5.9,10,6,4,60,0,1,1,0,100,3.2,1460,61,http://content9.flixster.com/movie/10/89/54/10895447_det.jpg,-1
3756,The Golden Bowl,200669,La copa dorada,"http://ia.media-imdb.com/images/M/MV5BMTQyNTI0OTY3M15BMl5BanBnXkFtZTcwMDI1MTQyMQ@@._V1._SX214_CR0,0,214,314_.jpg",2000,golden_bowl,5.3,85,45,40,52,5.6,27,15,12,55,3,832,38,http://content8.flixster.com/movie/27/14/271410_det.jpg,14
2471,'Crocodile' Dundee II,92493,'Crocodile' Dundee II,"http://ia.media-imdb.com/images/M/MV5BMTgxOTg3NTM3OF5BMl5BanBnXkFtZTcwNjgwODgyMQ@@._V1._SY314_CR3,0,214,314_.jpg",1988,crocodile_dundee_2,3.6,21,3,18,14,0,0,0,0,0,0,0,0,http://content8.flixster.com/movie/25/68/256818_det.jpg,14
5202,Mon oncle d'Amérique,81176,Mi tío de América,"http://ia.media-imdb.com/images/M/MV5BMTcyODMxMDMxMl5BMl5BanBnXkFtZTcwNzg0MzYyMQ@@._V1._SY314_CR3,0,214,314_.jpg",1980,mon_oncle_damerique,8.1,9,9,0,100,0,2,2,0,100,3.9,640,84,http://content7.flixster.com/movie/11/15/03/11150361_det.jpg,16
25797,Gold Diggers of 1933,24069,Vampiresas 1933,"http://ia.media-imdb.com/images/M/MV5BMTc0OTM5MzkxMl5BMl5BanBnXkFtZTcwNzQ0MTUzMQ@@._V1._SY314_CR4,0,214,314_.jpg",1933,gold_diggers_of_1933,9,8,8,0,100,0,0,0,0,0,0,0,0,http://content7.flixster.com/movie/10/87/99/10879965_det.jpg,100
7057,A Midsummer Night's Dream,140379,"El sueño de una noche de verano, de William Shakespeare","http://ia.media-imdb.com/images/M/MV5BMTIyMTU2NTc1N15BMl5BanBnXkFtZTcwNDY1MjgxMQ@@._V1._SY314_CR0,0,214,314_.jpg",1999,tales-of-the-night-fairies,0,0,0,0,0,0,0,0,0,0,0,0,0,http://images.rottentomatoescdn.com/images/defaults/poster_default.gif,0
1623,Wishmaster,120524,Wishmaster,"http://ia.media-imdb.com/images/M/MV5BMTM3NzgwNDAwNl5BMl5BanBnXkFtZTcwNzMwOTAyMQ@@._V1._SY314_CR3,0,214,314_.jpg",1997,wishmaster,3.4,27,6,21,22,2.9,5,1,4,20,2.8,3480,48,http://content7.flixster.com/movie/28/32/283225_det.jpg,-26
7280,Blacula,68284,Drácula negro,"http://ia.media-imdb.com/images/M/MV5BMTU1Mjk1NjI3MV5BMl5BanBnXkFtZTcwNTE4NTQyMQ@@._V1._SY314_CR8,0,214,314_.jpg",1972,blacula,5.1,19,8,11,42,0,2,1,1,50,2.8,1108,42,http://content9.flixster.com/movie/95/83/95/9583951_det.jpg,0
6131,Some Kind of Hero,83107,Some Kind of Hero,"http://ia.media-imdb.com/images/M/MV5BMTc1MzM2NjkyNF5BMl5BanBnXkFtZTYwNzYxMDk5._V1._SX214_CR0,0,214,314_.jpg",1982,some_kind_of_hero,0,0,0,0,0,0,0,0,0,0,0,0,0,http://content7.flixster.com/movie/10/85/54/10855481_det.jpg,0
6724,Paper Moon,70510,Luna de papel,"http://ia.media-imdb.com/images/M/MV5BMTczMjA1NTQwNV5BMl5BanBnXkFtZTcwOTMyMDUyMQ@@._V1._SY314_CR2,0,214,314_.jpg",1973,paper_moon,8.4,29,26,3,89,8,6,4,2,66,4,3053,91,http://content6.flixster.com/movie/10/88/37/10883792_det.jpg,-2
52561,Yihe yuan,794374,Yihe yuan,"http://ia.media-imdb.com/images/M/MV5BMTg0NjkwMjAzOV5BMl5BanBnXkFtZTcwNzQ3Mjc1MQ@@._V1._SY314_CR4,0,214,314_.jpg",2006,yihe-yuan,6.2,28,19,9,67,6.6,10,8,2,80,3.4,653,59,http://content8.flixster.com/movie/10/83/85/10838562_det.jpg,8
4505,For Keeps?,95169,La que hemos armado,"http://ia.media-imdb.com/images/M/MV5BMTY2NjI3MTM5OF5BMl5BanBnXkFtZTcwNTE4MTUyMQ@@._V1._SY314_CR0,0,214,314_.jpg",1988,for_keeps,4.3,9,2,7,22,0,1,1,0,100,3.4,2404,64,http://content8.flixster.com/movie/10/84/53/10845358_det.jpg,-42
62803,Kozure Ôkami: Oya no kokoro ko no kokoro,143348,Kozure Ôkami: Oya no kokoro ko no kokoro,"http://ia.media-imdb.com/images/M/MV5BMTQ2MzQyOTI3NV5BMl5BanBnXkFtZTcwNTEwNTUyMQ@@._V1._SY314_CR4,0,214,314_.jpg",1972,lone-wolf-and-cub-baby-cart-in-peril,0,1,1,0,100,0,0,0,0,0,0,0,0,http://content6.flixster.com/movie/31/38/313816_det.jpg,100
8665,The Bourne Supremacy,372183,El mito de Bourne,"http://ia.media-imdb.com/images/M/MV5BMTAxODk0MjEyMjZeQTJeQWpwZ15BbWU2MDgzMzExNw@@._V1._SX214_CR0,0,214,314_.jpg",2004,bourne_supremacy,7.2,185,150,35,81,7,39,29,10,74,3.9,111547,89,http://content8.flixster.com/movie/10/81/65/10816574_det.jpg,-8
63222,JCVD,1130988,JCVD,"http://ia.media-imdb.com/images/M/MV5BNDAwMDg5MTY1N15BMl5BanBnXkFtZTcwMTU1MjcwMg@@._V1._SY314_CR7,0,214,314_.jpg",2008,jcvd,7,98,83,15,84,7.1,25,21,4,84,3.5,8534,71,http://content7.flixster.com/movie/10/86/16/10861693_det.jpg,13
5329,The Salton Sea,235737,The Salton Sea,"http://ia.media-imdb.com/images/M/MV5BMjkwOTQyNzYxMl5BMl5BanBnXkFtZTcwOTk1MTMyMQ@@._V1._SY314_CR8,0,214,314_.jpg",2002,salton_sea,5.8,84,53,31,63,5.5,25,14,11,56,3.7,4972,81,http://content8.flixster.com/movie/10/92/75/10927510_det.jpg,-18
59105,Where in the World Is Osama Bin Laden?,963208,Where in the World Is Osama Bin Laden?,"http://ia.media-imdb.com/images/M/MV5BMjEzMTA2ODQ4NV5BMl5BanBnXkFtZTcwNzE4MjU2MQ@@._V1._SX214_CR0,0,214,314_.jpg",2008,where_in_the_world_is_osama_bin_laden,4.9,102,38,64,37,4.6,29,9,20,31,3.3,2558,55,http://content9.flixster.com/movie/10/85/36/10853683_det.jpg,-18
5721,The Chosen,82175,Los elegidos,"http://ia.media-imdb.com/images/M/MV5BODk5MTY2MzEzMF5BMl5BanBnXkFtZTcwMzUyMTAyMQ@@._V1._SY314_CR5,0,214,314_.jpg",1981,1004110-chosen,5.6,9,7,2,77,0,2,2,0,100,3.8,256,78,http://content6.flixster.com/movie/25/67/256792_det.jpg,-1
2031,The Million Dollar Duck,66728,Millonarios por una pata,"http://ia.media-imdb.com/images/M/MV5BMTI1ODMyMTU5NV5BMl5BanBnXkFtZTcwMDY5OTcyMQ@@._V1._SY314_CR1,0,214,314_.jpg",1971,million_dollar_duck,3.5,5,0,5,0,0,1,0,1,0,0,0,0,http://content8.flixster.com/movie/25/17/251714_det.jpg,0
6454,Music Box,100211,La caja de música,"http://ia.media-imdb.com/images/M/MV5BMjA0MTQ3MjQxNF5BMl5BanBnXkFtZTcwNTYzMjAwMQ@@._V1._SY292_CR1,0,214,292_.jpg",1989,1014451-music_box,6.4,14,9,5,64,0,1,0,1,0,0,0,0,http://content9.flixster.com/movie/26/25/262527_det.jpg,64
31878,Kung fu,373074,Kung Fu sion,"http://ia.media-imdb.com/images/M/MV5BMjQwNTMwODU0Ml5BMl5BanBnXkFtZTcwODkzNjgyMQ@@._V1._SX214_CR0,0,214,314_.jpg",2004,kung_fu_hustle,7.6,172,154,18,89,7.4,39,33,6,84,3.6,37633,86,http://content6.flixster.com/movie/10/88/90/10889084_det.jpg,3
4877,Better Than Sex,236019,Mejor que el sexo,"http://ia.media-imdb.com/images/M/MV5BMTU3MzE2ODkzMF5BMl5BanBnXkFtZTcwMjA5NjQyMQ@@._V1._SY314_CR0,0,214,314_.jpg",2000,love_and_sex,5.2,48,23,25,47,5.2,12,6,6,50,3.7,1847,76,http://content8.flixster.com/movie/34/99/64/3499646_det.jpg,-29
2459,The Texas Chainsaw Massacre,324216,La matanza de Texas,"http://ia.media-imdb.com/images/M/MV5BMjE2Nzc4NjAzM15BMl5BanBnXkFtZTcwNDE4MTYyMQ@@._V1._SX214_CR0,0,214,314_.jpg",2003,texas_chainsaw_massacre,4.8,152,55,97,36,4.2,33,6,27,18,3.2,36030,67,http://content7.flixster.com/movie/11/13/31/11133149_det.jpg,-31
4030,Dracula 2000,219653,Dracula 2001,"http://ia.media-imdb.com/images/M/MV5BMjAxODgyMTQ1OF5BMl5BanBnXkFtZTcwNDI1NjMyMQ@@._V1._SY314_CR3,0,214,314_.jpg",2000,immortality2000,0,0,0,0,0,0,0,0,0,0,0,0,0,http://content6.flixster.com/movie/10/85/16/10851624_det.jpg,0
49822,The Good Shepherd,343737,El buen pastor,"http://ia.media-imdb.com/images/M/MV5BMTkzNTIzMjk1OV5BMl5BanBnXkFtZTcwNzY2NzI0MQ@@._V1._SY314_CR3,0,214,314_.jpg",2006,good_shepherd,6.1,167,90,77,53,6.3,38,21,17,55,3.1,51101,52,http://content8.flixster.com/movie/11/12/80/11128054_det.jpg,1
8680,Tras el cristal,90197,Tras el cristal,"http://ia.media-imdb.com/images/M/MV5BMjE3Nzc2MjM0NV5BMl5BanBnXkFtZTcwMDQzODUyMQ@@._V1._SY314_CR4,0,214,314_.jpg",1987,in-a-glass-cage,5,6,3,3,50,0,4,2,2,50,3.7,441,77,http://content6.flixster.com/movie/28/75/287508_det.jpg,-27
4023,The Family Man,218967,Family Man,"http://ia.media-imdb.com/images/M/MV5BMTI2Mjc0MDYyOV5BMl5BanBnXkFtZTcwMzA5MDQyMQ@@._V1._SY314_CR5,0,214,314_.jpg",2000,family_man,5.4,125,65,60,52,4.7,31,11,20,35,3.1,19358,66,http://content7.flixster.com/movie/10/84/98/10849849_det.jpg,-14
49772,The Painted Veil,446755,El velo pintado,"http://ia.media-imdb.com/images/M/MV5BMTMzODg4MjU4OF5BMl5BanBnXkFtZTYwNDAzNTU3._V1._SX214_CR0,0,214,314_.jpg",2006,painted_veil,7.1,143,106,37,74,7.3,35,26,9,74,3.9,20954,85,http://content8.flixster.com/movie/10/87/40/10874006_det.jpg,-11
4719,Osmosis Jones,181739,Ósmosis Jones,"http://ia.media-imdb.com/images/M/MV5BMTk5NTg2NzM0OV5BMl5BanBnXkFtZTYwNTk5Mjg5._V1._SX214_CR0,0,214,314_.jpg",2001,osmosis_jones,5.5,106,57,49,53,5.5,29,16,13,55,2.8,7220,40,http://content6.flixster.com/movie/10/91/51/10915192_det.jpg,13
50356,Don Camillo,43918,Don Camilo,"http://ia.media-imdb.com/images/M/MV5BMTI3NjM0NzY3NF5BMl5BanBnXkFtZTcwNTUyOTMyMQ@@._V1._SY314_CR3,0,214,314_.jpg",1952,little_world_of_don_camillo,0,0,0,0,0,0,0,0,0,0,0,0,0,http://content6.flixster.com/movie/10/83/93/10839368_det.jpg,0
52591,The Contract,445946,The Contract,"http://ia.media-imdb.com/images/M/MV5BMjEzNTIwMjg2OV5BMl5BanBnXkFtZTcwMzMxNzg0MQ@@._V1._SY314_CR2,0,214,314_.jpg",2006,1177488-contract,4.3,5,0,5,0,0,0,0,0,0,0,0,0,http://content6.flixster.com/movie/10/88/96/10889636_det.jpg,0
5087,Préparez vos mouchoirs,78122,¿Quiere ser el amante de mi mujer?,"http://ia.media-imdb.com/images/M/MV5BMjE4MTQ5MTM4Nl5BMl5BanBnXkFtZTcwMDc3NTEyMQ@@._V1._SY314_CR9,0,214,314_.jpg",1978,get_out_your_handkerchiefs,6.6,9,8,1,88,0,0,0,0,0,0,0,0,http://content7.flixster.com/movie/10/92/54/10925425_det.jpg,88
5950,The Jimmy Show,271020,The Jimmy Show,"http://ia.media-imdb.com/images/M/MV5BMTU5OTczNzI4OF5BMl5BanBnXkFtZTcwMDkzMjUxMQ@@._V1._SY314_CR4,0,214,314_.jpg",2001,jimmy_show,5,10,4,6,40,0,3,0,3,0,2.8,238,30,http://content8.flixster.com/movie/28/40/284010_det.jpg,10
6446,The Comancheros,54757,Los comancheros,"http://ia.media-imdb.com/images/M/MV5BMTAwNTg0OTU3MTReQTJeQWpwZ15BbWU2MDgyMjY5OQ@@._V1._SY314_CR6,0,214,314_.jpg",1961,comancheros,0,4,4,0,100,0,0,0,0,0,0,0,0,http://content7.flixster.com/movie/29/34/293425_det.jpg,100
5535,Comment j'ai tué mon père,268219,Comment j'ai tué mon père,"http://ia.media-imdb.com/images/M/MV5BNjQ1MDg5NDkwM15BMl5BanBnXkFtZTcwOTk5MTYyMQ@@._V1._SY314_CR3,0,214,314_.jpg",2001,how-i-killed-my-father,0,0,0,0,0,0,0,0,0,0,0,0,0,http://content7.flixster.com/movie/10/85/15/10851561_det.jpg,0
58301,Funny Games U.S.,808279,Funny Games,"http://ia.media-imdb.com/images/M/MV5BMTg4OTExNTYzMV5BMl5BanBnXkFtZTcwOTg1MDU1MQ@@._V1._SX214_CR0,0,214,314_.jpg",2007,1175174-funny_games,5.6,138,71,67,51,4.7,34,13,21,38,3.2,16153,54,http://content8.flixster.com/movie/10/88/03/10880338_det.jpg,-3
31042,Hell's Angels,20960,Los ángeles del infierno,"http://ia.media-imdb.com/images/M/MV5BMTc1NTk3NDEwNV5BMl5BanBnXkFtZTcwMTIzMzcyMQ@@._V1._SY314_CR3,0,214,314_.jpg",1930,hells_angels,7.3,10,9,1,90,0,0,0,0,0,0,0,0,http://content7.flixster.com/movie/10/87/08/10870805_det.jpg,90
2368,King Kong Lives,91344,King Kong 2,"http://ia.media-imdb.com/images/M/MV5BNzgyNjE1Njc0MF5BMl5BanBnXkFtZTcwNzgzMTYyMQ@@._V1._SY298_CR1,0,214,298_.jpg",1986,king_kong_lives,1.6,9,0,9,0,0,2,0,2,0,2.7,5069,37,http://content6.flixster.com/movie/10/93/36/10933604_det.jpg,-37
5553,Stakeout,94025,Procedimiento ilegal,"http://ia.media-imdb.com/images/M/MV5BMTIwOTUzMDAwOF5BMl5BanBnXkFtZTcwNDc0NDAyMQ@@._V1._SY314_CR3,0,214,314_.jpg",1987,1019779-stakeout,6.5,18,15,3,83,0,1,1,0,100,2.9,2040,50,http://content7.flixster.com/movie/27/16/271625_det.jpg,33
7253,It,18033,Ello,"http://ia.media-imdb.com/images/M/MV5BMTIwOTQ2MTMwM15BMl5BanBnXkFtZTcwMzk2NzYyMQ@@._V1._SX214_CR0,0,214,314_.jpg",1927,1010770-it,6.6,8,8,0,100,0,1,1,0,100,3.7,773,78,http://content8.flixster.com/movie/30/59/305902_det.jpg,22
6265,Head of State,325537,De incompetente a presidente (Head of state),"http://ia.media-imdb.com/images/M/MV5BMTMwMzUxMDY2NV5BMl5BanBnXkFtZTcwNDAzMjAwMQ@@._V1._SX214_CR0,0,214,314_.jpg",2003,head_of_state,4.8,116,35,81,30,4.8,26,7,19,26,2.8,5662,51,http://content6.flixster.com/movie/10/92/33/10923344_det.jpg,-21
2009,Soylent Green,70723,Soylent Green: Cuando el destino nos alcance,"http://ia.media-imdb.com/images/M/MV5BMTI1MjcxMzI1M15BMl5BanBnXkFtZTcwOTA5MDAwMQ@@._V1._SY314_CR1,0,214,314_.jpg",1973,soylent_green,6,31,22,9,70,0,3,0,3,0,3.5,5747,71,http://content9.flixster.com/movie/25/44/254491_det.jpg,-1
6257,Jag är nyfiken - en film i gult,61834,Soy curiosa amarillo,http://ia.media-imdb.com/images/M/MV5BMTQ5NTc1MjgwMF5BMl5BanBnXkFtZTcwMTQ0NTgxMQ@@._V1._SX77_SY140_.jpg,1967,i_am_curious_blue,5.2,24,12,12,50,0,4,2,2,50,3.6,513,64,http://content7.flixster.com/movie/89/94/04/8994041_det.jpg,-14
3419,Something for Everyone,66392,Corrupción de una familia,"http://ia.media-imdb.com/images/M/MV5BMTIxNDg5MzIxMl5BMl5BanBnXkFtZTcwNjgxMjkxMQ@@._V1._SX214_CR0,0,214,314_.jpg",1970,something_for_everyone,0,2,1,1,50,0,0,0,0,0,0,0,0,http://content8.flixster.com/movie/10/95/99/10959962_det.jpg,50
25866,The Sea Hawk,33028,El halcón del mar,"http://ia.media-imdb.com/images/M/MV5BMjcwNDQ2NTQ5Ml5BMl5BanBnXkFtZTcwODQwMjgyMQ@@._V1._SY314_CR24,0,214,314_.jpg",1940,1018433-sea_hawk,8.7,12,12,0,100,0,0,0,0,0,0,0,0,http://content6.flixster.com/movie/10/36/26/10362676_det.jpg,100
1723,Twisted,315297,Giro inesperado,"http://ia.media-imdb.com/images/M/MV5BMTg1OTk4NDA3M15BMl5BanBnXkFtZTcwMDYzOTQyMQ@@._V1._SX214_CR0,0,214,314_.jpg",2004,twisted,2.9,132,2,130,1,3.2,36,0,36,0,2.8,2961,40,http://content6.flixster.com/movie/27/63/276304_det.jpg,-39
3147,The Green Mile,120689,La milla verde,"http://ia.media-imdb.com/images/M/MV5BMTUxMzQyNjA5MF5BMl5BanBnXkFtZTYwOTU2NTY3._V1._SX214_CR0,0,214,314_.jpg",1999,green_mile,6.8,128,99,29,77,6.2,32,23,9,71,4.1,124792,93,http://content7.flixster.com/movie/26/73/267305_det.jpg,-16
544,Striking Distance,108238,Persecución mortal,"http://ia.media-imdb.com/images/M/MV5BMjA2NTg2Mzc0NF5BMl5BanBnXkFtZTcwMjYxNjYyMQ@@._V1._SY314_CR1,0,214,314_.jpg",1993,striking_distance,3.6,19,3,16,15,0,2,0,2,0,2.8,4532,39,http://content8.flixster.com/movie/27/27/272702_det.jpg,-24
3993,Quills,180073,Quills,"http://ia.media-imdb.com/images/M/MV5BMjAzMTYxMjc1Ml5BMl5BanBnXkFtZTcwNTE1ODkxMQ@@._V1._SY314_CR3,0,214,314_.jpg",2000,quills,6.6,118,88,30,74,6.2,35,25,10,71,3.6,9122,81,http://content7.flixster.com/movie/27/08/270809_det.jpg,-7
3491,My Chauffeur,91579,Mi chófer,"http://ia.media-imdb.com/images/M/MV5BMjA2OTg1NTQ4NV5BMl5BanBnXkFtZTcwNzI0NzMzMQ@@._V1._SY314_CR5,0,214,314_.jpg",1986,my_chauffeur,0,1,0,1,0,0,0,0,0,0,0,0,0,http://content7.flixster.com/movie/10/88/24/10882473_det.jpg,0
8266,Purple Rain,87957,Purple Rain,"http://ia.media-imdb.com/images/M/MV5BMTAyODQwMDQxNTdeQTJeQWpwZ15BbWU3MDQyOTc2MjE@._V1._SY314_CR21,0,214,314_.jpg",1984,purple_rain,6.3,29,22,7,75,0,2,1,1,50,3.3,7627,78,http://content6.flixster.com/movie/10/04/08/10040820_det.jpg,-3
3272,Bad Lieutenant,103759,Bad Lieutenant,"http://ia.media-imdb.com/images/M/MV5BMTg1MjQ4MjgwNV5BMl5BanBnXkFtZTcwNTA0NjY0MQ@@._V1._SY314_CR7,0,214,314_.jpg",1992,bad_lieutenant,6.9,38,29,9,76,6.7,10,7,3,70,3.5,4087,73,http://content9.flixster.com/movie/27/04/270407_det.jpg,3
33188,Mischief,89601,Mischief,"http://ia.media-imdb.com/images/M/MV5BMTk3MjQ2MzI2N15BMl5BanBnXkFtZTcwODQ1MzgyMQ@@._V1._SY314_CR4,0,214,314_.jpg",1985,1013984-mischief,5.2,5,3,2,60,0,0,0,0,0,0,0,0,http://content8.flixster.com/movie/26/76/267626_det.jpg,60
4947,The Gauntlet,76070,Ruta suicida,"http://ia.media-imdb.com/images/M/MV5BMTMyNDEzNjA3OV5BMl5BanBnXkFtZTcwNjk2NDUxMQ@@._V1._SY314_CR9,0,214,314_.jpg",1977,gauntlet,6.1,16,13,3,81,0,1,1,0,100,3.2,2342,53,http://content6.flixster.com/movie/27/28/272812_det.jpg,28
3472,The City of the Dead,53719,The City of the Dead,"http://ia.media-imdb.com/images/M/MV5BMTU4NjgyNDE4OF5BMl5BanBnXkFtZTcwNjAyMDUyMQ@@._V1._SY314_CR2,0,214,314_.jpg",1960,horror_hotel,0,4,2,2,50,0,0,0,0,0,0,0,0,http://content9.flixster.com/movie/26/61/266127_det.jpg,50
3001,The Suburbans,157075,The Suburbans,"http://ia.media-imdb.com/images/M/MV5BMTg3OTMzNjE2OV5BMl5BanBnXkFtZTcwNjY4MTkxMQ@@._V1._SY314_CR6,0,214,314_.jpg",1999,suburbans,3,10,0,10,0,0,2,0,2,0,2.5,700,23,http://content9.flixster.com/movie/27/85/278515_det.jpg,-23
2789,Damien: Omen II,77394,La maldición de Damien,"http://ia.media-imdb.com/images/M/MV5BNjc1ODk3NTUyMF5BMl5BanBnXkFtZTcwODA5ODQyMQ@@._V1._SX214_CR0,0,214,314_.jpg",1978,damien_1978,0,0,0,0,0,0,0,0,0,0,0,0,0,http://images.rottentomatoescdn.com/images/defaults/poster_default.gif,0
26472,El Norte,85482,El Norte,"http://ia.media-imdb.com/images/M/MV5BMTI4MzYwNDM5MV5BMl5BanBnXkFtZTcwODMyMzMzMQ@@._V1._SY314_CR2,0,214,314_.jpg",1983,el_norte,7.5,9,8,1,88,0,0,0,0,0,0,0,0,http://content9.flixster.com/movie/93/08/17/9308179_det.png,88
64032,Four Christmases,369436,Como en casa en ningún sitio,http://ia.media-imdb.com/images/M/MV5BMTc0OTg5Mzc4MF5BMl5BanBnXkFtZTcwMDYwODAwMw@@._V1._SX150_SY189_.jpg,2008,four_christmases,4.3,139,35,104,25,4,27,5,22,18,3.3,79552,52,http://content7.flixster.com/movie/10/87/64/10876473_det.jpg,-27
2424,You've Got Mail,128853,Tienes un e-m@il,"http://ia.media-imdb.com/images/M/MV5BMTc1MzI5MTk2Ml5BMl5BanBnXkFtZTcwNDcxNzIzMQ@@._V1._SY314_CR11,0,214,314_.jpg",1998,youve_got_mail,6.2,75,51,24,68,6.4,20,15,5,75,3.1,60706,70,http://content9.flixster.com/movie/25/38/253811_det.jpg,-2
6622,Carnages,280523,Carnages,"http://ia.media-imdb.com/images/M/MV5BMTg4Mzk5MjA3Nl5BMl5BanBnXkFtZTcwODcwNDAwMQ@@._V1._SY314_CR1,0,214,314_.jpg",2002,1124952-carnage,6.9,36,28,8,77,7.1,11,9,2,81,3.7,239,71,http://content6.flixster.com/movie/28/95/289520_det.jpg,6
2965,The Omega Code,203408,Código Omega,"http://ia.media-imdb.com/images/M/MV5BMjA1NjQ5NTI0M15BMl5BanBnXkFtZTcwMzMzNzUxMQ@@._V1._SY314_CR3,0,214,314_.jpg",1999,omega_code,3,24,2,22,8,4.2,6,2,4,33,2.6,796,40,http://content6.flixster.com/movie/10/88/66/10886660_det.jpg,-32
2656,Tarantula,48696,Tarantula,"http://ia.media-imdb.com/images/M/MV5BMTk2ODgzMDEyOV5BMl5BanBnXkFtZTcwMjgwMDMyMQ@@._V1._SX214_CR0,0,214,314_.jpg",1955,tarantula,6.3,11,10,1,90,0,0,0,0,0,0,0,0,http://content8.flixster.com/movie/53/46/01/5346010_det.jpg,90
438,The Cowboy Way,109493,Vaqueros de Nueva York,"http://ia.media-imdb.com/images/M/MV5BMTY1OTQ2OTY5OV5BMl5BanBnXkFtZTYwMzg3MTk5._V1._SX214_CR0,0,214,314_.jpg",1994,cowboy_way,4.2,12,2,10,16,0,2,0,2,0,3,2782,61,http://content9.flixster.com/movie/10/88/51/10885187_det.jpg,-45
1569,My Best Friend's Wedding,119738,La boda de mi mejor amigo,"http://ia.media-imdb.com/images/M/MV5BNDI0ODY4NDQ1NV5BMl5BanBnXkFtZTcwMjcxNDIyMQ@@._V1._SY314_CR2,0,214,314_.jpg",1997,my_best_friends_wedding,6.5,54,39,15,72,5.9,17,10,7,58,3.3,64013,72,http://content7.flixster.com/movie/55/35/54/5535541_det.jpg,0
56167,Om Shanti Om,1024943,Om Shanti Om,"http://ia.media-imdb.com/images/M/MV5BMTgwMTc5MzMxOF5BMl5BanBnXkFtZTcwOTA4MTU1MQ@@._V1._SX214_CR0,0,214,314_.jpg",2007,om_shanti_om,6.9,7,6,1,85,0,1,1,0,100,4,9245,78,http://content6.flixster.com/movie/10/26/11/10261196_det.jpg,7
1379,Young Guns II,100994,Intrépidos forajidos,"http://ia.media-imdb.com/images/M/MV5BMTI5MDAzNzgyMV5BMl5BanBnXkFtZTcwMTQ3NDYyMQ@@._V1._SY314_CR2,0,214,314_.jpg",1990,young_guns_2,4.9,16,6,10,37,0,2,0,2,0,3.2,7476,67,http://content7.flixster.com/movie/11/14/43/11144321_det.jpg,-30
1406,La cérémonie,112769,La ceremonia,"http://ia.media-imdb.com/images/M/MV5BMTkwOTUzNzI0Nl5BMl5BanBnXkFtZTcwNzM1MDYyMQ@@._V1._SY314_CR4,0,214,314_.jpg",1995,1075705-ceremonie,7.7,27,25,2,92,7.4,12,11,1,91,3.9,747,85,http://content8.flixster.com/movie/30/64/306422_det.jpg,7
41566,"The Chronicles of Narnia: The Lion, the Witch and the Wardrobe",363771,"Las crónicas de Narnia - El león, la bruja y el armario","http://ia.media-imdb.com/images/M/MV5BMTc0NTUwMTU5OV5BMl5BanBnXkFtZTcwNjAwNzQzMw@@._V1._SX214_CR0,0,214,314_.jpg",2005,chronicles_of_narnia_lion_witch_wardrobe,6.9,206,156,50,75,7.1,38,29,9,76,3.1,260071,62,http://content8.flixster.com/movie/10/91/87/10918786_det.jpg,13
8891,"See No Evil, Hear No Evil",98282,"No me chilles, que no te veo","http://ia.media-imdb.com/images/M/MV5BMjAzOTE3MjE1NF5BMl5BanBnXkFtZTcwMTExODkxMQ@@._V1._SY314_CR3,0,214,314_.jpg",1989,see_no_evil_hear_no_evil,3.4,11,2,9,18,0,1,0,1,0,3.3,6015,72,http://content8.flixster.com/movie/26/93/269306_det.jpg,-54
2180,Torn Curtain,61107,Cortina rasgada,"http://ia.media-imdb.com/images/M/MV5BNTEyNDYyNzM2OV5BMl5BanBnXkFtZTYwNjc3OTA5._V1._SX214_CR0,0,214,314_.jpg",1966,torn_curtain,6.5,16,13,3,81,0,1,0,1,0,3.3,2910,55,http://content9.flixster.com/movie/25/86/258619_det.jpg,26
27801,Ong-bak,368909,Ong-Bak: El guerrero Muay Thai,"http://ia.media-imdb.com/images/M/MV5BMTIzMTUzMzc2MF5BMl5BanBnXkFtZTcwMjIyMzAzMQ@@._V1._SY314_CR3,0,214,314_.jpg",2003,ongbak,6.9,102,87,15,85,6.5,25,19,6,76,3.8,16639,85,http://content8.flixster.com/movie/26/69/266994_det.jpg,0
6155,How to Lose a Guy in 10 Days,251127,Cómo perder a un chico en 10 días,"http://ia.media-imdb.com/images/M/MV5BMjE4NTA1NzExN15BMl5BanBnXkFtZTYwNjc3MjM3._V1._SX214_CR0,0,214,314_.jpg",2003,how_to_lose_a_guy_in_10_days,5,145,62,83,42,4.9,34,12,22,35,3.4,131729,78,http://content9.flixster.com/movie/10/91/74/10917463_det.jpg,-36
450,With Honors,111732,Un intruso en Harvard,"http://ia.media-imdb.com/images/M/MV5BMTkzMjA3NTk4MF5BMl5BanBnXkFtZTcwNDg3MzIyMQ@@._V1._SY314_CR3,0,214,314_.jpg",1994,with_honors,4,21,4,17,19,0,3,0,3,0,3.3,3484,72,http://content8.flixster.com/movie/25/81/258122_det.jpg,-53
52606,Big Nothing,488085,La gran nada,"http://ia.media-imdb.com/images/M/MV5BMTY5NTc2NjYwOV5BMl5BanBnXkFtZTcwMzk5OTY0MQ@@._V1._SY314_CR3,0,214,314_.jpg",2006,big_nothing,0,3,3,0,100,0,0,0,0,0,0,0,0,http://content9.flixster.com/movie/10/86/03/10860311_det.jpg,100
26241,The Devil's Advocate,118971,Pactar con el diablo,"http://ia.media-imdb.com/images/M/MV5BMTAxMjg2MzA4MTNeQTJeQWpwZ15BbWU3MDM5OTA1NTE@._V1._SY314_CR9,0,214,314_.jpg",1997,devils_advocate,6.2,43,28,15,65,5.8,10,4,6,40,3.4,30966,78,http://content6.flixster.com/movie/83/07/830796_det.jpg,-13
2950,The Blue Lagoon,80453,El lago azul,"http://ia.media-imdb.com/images/M/MV5BMTQ3NzQzNzg2MV5BMl5BanBnXkFtZTcwMjEwMjAzMQ@@._V1._SY314_CR3,0,214,314_.jpg",1980,blue_lagoon,2.7,17,2,15,11,0,4,1,3,25,2.8,7063,55,http://content8.flixster.com/movie/10/92/42/10924290_det.jpg,-44
3914,The Broken Hearts Club: A Romantic Comedy,222850,El club de los corazones rotos,"http://ia.media-imdb.com/images/M/MV5BMTIzNjAzMzY5OF5BMl5BanBnXkFtZTcwMzE1OTUyMQ@@._V1._SY314_CR3,0,214,314_.jpg",2000,broken_hearts_club,6,27,17,10,62,0,4,3,1,75,3.6,2111,70,http://content9.flixster.com/movie/10/95/55/10955507_det.jpg,-8
3078,Liberty Heights,165859,Liberty Heights,"http://ia.media-imdb.com/images/M/MV5BMjA1NTc3NTAzM15BMl5BanBnXkFtZTcwNjk0NTYyMQ@@._V1._SY314_CR9,0,214,314_.jpg",1999,liberty_heights,7.3,45,39,6,86,7.8,11,11,0,100,3.4,1048,71,http://content7.flixster.com/movie/10/89/17/10891709_det.jpg,15
4297,Pelle erobreren,93713,"Pelle, el conquistador","http://ia.media-imdb.com/images/M/MV5BMTY0Njg2MjQ5NV5BMl5BanBnXkFtZTcwODYyOTUyMQ@@._V1._SY314_CR2,0,214,314_.jpg",1987,pelle_the_conqueror,7.3,8,8,0,100,0,1,1,0,100,3.9,852,86,http://content9.flixster.com/movie/10/93/54/10935431_det.jpg,14
8946,Surviving Christmas,252028,Sobreviviendo a la Navidad,"http://ia.media-imdb.com/images/M/MV5BMTcwMTI4MTY3Ml5BMl5BanBnXkFtZTcwOTUzMjcyMQ@@._V1._SX214_CR0,0,214,314_.jpg",2004,surviving_christmas,3,109,8,101,7,2.9,29,2,27,6,2.6,4192,37,http://content8.flixster.com/movie/56/19/48/5619486_det.jpg,-30
45981,Hollow Man II,469916,Hollow Man II,"http://ia.media-imdb.com/images/M/MV5BNjY1MjM1Mzg0NF5BMl5BanBnXkFtZTcwMTQyODIzMQ@@._V1._SY314_CR5,0,214,314_.jpg",2006,hollow_man_ii,0,4,0,4,0,0,0,0,0,0,0,0,0,http://content6.flixster.com/movie/17/95/05/1795052_det.jpg,0
3034,Robin Hood: Prince of Thieves,102798,"Robin Hood, príncipe de los ladrones","http://ia.media-imdb.com/images/M/MV5BMTI2NzY5Mjk4OV5BMl5BanBnXkFtZTYwODExOTk5._V1._SY314_CR10,0,214,314_.jpg",1991,robin_hood_prince_of_thieves,5.2,27,15,12,55,0,2,1,1,50,3.4,30722,72,http://content6.flixster.com/movie/10/93/73/10937328_det.jpg,-17
40581,Just Friends,433400,Sólo amigos,"http://ia.media-imdb.com/images/M/MV5BMjA0Mzg2NjUzMl5BMl5BanBnXkFtZTcwNDg2ODUzMQ@@._V1._SX214_CR0,0,214,314_.jpg",2005,just_friends,5.1,96,40,56,41,5,27,10,17,37,3.4,46041,73,http://content6.flixster.com/movie/25/06/250604_det.jpg,-32
5712,Blow Out,82085,Impacto,"http://ia.media-imdb.com/images/M/MV5BMTg4NTMzODEwMF5BMl5BanBnXkFtZTcwMzEwOTIyMQ@@._V1._SY314_CR2,0,214,314_.jpg",1981,blow_out,7.5,36,32,4,88,7.1,5,4,1,80,3.6,2727,74,http://content6.flixster.com/movie/10/87/44/10874488_det.jpg,14
2881,Double Jeopardy,150377,Doble traición,"http://ia.media-imdb.com/images/M/MV5BMTQ3OTU3MTIyNV5BMl5BanBnXkFtZTcwMDY0NjIyMQ@@._V1._SY314_CR2,0,214,314_.jpg",1999,1093614-double_jeopardy,4.4,83,21,62,25,4.1,21,4,17,19,3.2,12512,68,http://content6.flixster.com/movie/26/97/269724_det.jpg,-43
2985,RoboCop,93870,RoboCop,"http://ia.media-imdb.com/images/M/MV5BMTgwOTI2NjIwNF5BMl5BanBnXkFtZTcwMTg0OTM1MQ@@._V1._SY314_CR3,0,214,314_.jpg",1987,1017712-robocop,7.7,42,37,5,88,7.3,7,6,1,85,3.1,18381,71,http://content7.flixster.com/movie/29/03/290309_det.jpg,17
2093,Return to Oz,89908,"Oz, un mundo fantástico","http://ia.media-imdb.com/images/M/MV5BMTQ4ODQyNDU3MV5BMl5BanBnXkFtZTcwODUyNTUyMQ@@._V1._SY314_CR2,0,214,314_.jpg",1985,1017488-return_to_oz,5.7,20,11,9,55,0,3,1,2,33,3.1,14348,62,http://content7.flixster.com/movie/26/51/265105_det.jpg,-7
7040,To Live and Die in L.A.,90180,Vivir y morir en Los Ángeles,"http://ia.media-imdb.com/images/M/MV5BMjA5ODY1NDY3MV5BMl5BanBnXkFtZTYwOTM3NzY4._V1._SX214_CR0,0,214,314_.jpg",1985,to_live_and_die_in_la,7.1,23,20,3,86,0,1,1,0,100,3.6,2714,74,http://content7.flixster.com/movie/10/85/62/10856229_det.jpg,12
3540,Passion of Mind,160644,Pasión por vivir,"http://ia.media-imdb.com/images/M/MV5BNjMxNjg1NjY2OF5BMl5BanBnXkFtZTcwOTIwNDMyMQ@@._V1._SX214_CR0,0,214,314_.jpg",2000,passion_of_mind,3.9,33,5,28,15,3.8,7,0,7,0,3.1,711,45,http://content9.flixster.com/movie/10/87/84/10878467_det.jpg,-30
4496,DOA: Dead or Alive,398913,DOA: Dead or Alive,"http://ia.media-imdb.com/images/M/MV5BMTIyNDQ0NDExMl5BMl5BanBnXkFtZTcwODAxMTk0MQ@@._V1._SX214_CR0,0,214,314_.jpg",2006,doa_dead_or_alive,4.5,44,15,29,34,4.2,10,2,8,20,2.7,71044,43,http://content7.flixster.com/movie/10/93/50/10935009_det.jpg,-9
2388,Hamam,119248,Hamam: el baño turco,http://ia.media-imdb.com/images/M/MV5BMjEyNjkzODMxMl5BMl5BanBnXkFtZTcwOTIwMjgxMQ@@._V1._SX101_SY140_.jpg,1997,steam_the_turkish_bath,6.3,16,13,3,81,6.4,5,3,2,60,3.7,781,75,http://content6.flixster.com/movie/10/88/94/10889472_det.jpg,6
3595,Held Up,165831,Secuestro por accidente,"http://ia.media-imdb.com/images/M/MV5BMjA1OTE2MDQ0OV5BMl5BanBnXkFtZTcwNTg1MjgxMQ@@._V1._SY314_CR4,0,214,314_.jpg",1999,held_up,3.3,30,5,25,16,3,8,1,7,12,2.9,580,48,http://content9.flixster.com/movie/26/54/265495_det.jpg,-32
5736,Faces of Death III,121261,Faces of Death III,"http://ia.media-imdb.com/images/M/MV5BMTI4NDIxMjk5MV5BMl5BanBnXkFtZTcwMjQyODcxMQ@@._V1._SY314_CR5,0,214,314_.jpg",1985,faces_of_death_pt_3,0,0,0,0,0,0,0,0,0,0,0,0,0,http://content8.flixster.com/movie/10/84/03/10840314_det.jpg,0
4497,Dead Heat,94961,Estamos muertos... ¿o qué?,"http://ia.media-imdb.com/images/M/MV5BNTYxMDA5MDIzNl5BMl5BanBnXkFtZTcwMjgzNTQyMQ@@._V1._SY314_CR4,0,214,314_.jpg",1988,1005399-dead_heat,0,3,1,2,33,0,0,0,0,0,0,0,0,http://content7.flixster.com/movie/27/42/274209_det.jpg,33
3732,Balls of Fury,424823,Pelotas en juego,"http://ia.media-imdb.com/images/M/MV5BMjA3MDQ1Mzc4N15BMl5BanBnXkFtZTcwODI0NTc0MQ@@._V1._SX214_CR0,0,214,314_.jpg",2007,balls_of_fury,4.2,127,29,98,22,4.5,24,8,16,33,2.8,85682,36,http://content6.flixster.com/movie/10/92/34/10923416_det.jpg,-14
1340,Bride of Frankenstein,26138,La novia de Frankenstein,"http://ia.media-imdb.com/images/M/MV5BMjAzNzMyNzI2M15BMl5BanBnXkFtZTcwMzI5NDAyMQ@@._V1._SY314_CR3,0,214,314_.jpg",1935,bride_of_frankenstein,8.9,39,39,0,100,8.6,6,6,0,100,3.7,4867,82,http://content8.flixster.com/movie/30/28/302822_det.jpg,18
7217,Dark Passage,39302,La senda tenebrosa,"http://ia.media-imdb.com/images/M/MV5BMTk2MzI5MTk5N15BMl5BanBnXkFtZTcwNDExNDYxMQ@@._V1._SY314_CR3,0,214,314_.jpg",1947,dark_passage,7.6,14,13,1,92,0,0,0,0,0,0,0,0,http://content6.flixster.com/movie/29/39/293912_det.jpg,92
27869,Taegukgi hwinalrimyeo,386064,Lazos de guerra,"http://ia.media-imdb.com/images/M/MV5BMTc1MDYxMjk1Ml5BMl5BanBnXkFtZTcwMjE4MzcyMQ@@._V1._SY314_CR3,0,214,314_.jpg",2004,taegukgi_the_brotherhood_of_war,6.7,41,33,8,80,6.6,17,14,3,82,4.2,5475,91,http://content7.flixster.com/movie/10/93/75/10937581_det.jpg,-11
3079,Mansfield Park,178737,Mansfield Park,"http://ia.media-imdb.com/images/M/MV5BMTUwMDIwNDMyN15BMl5BanBnXkFtZTcwNTAyNTEzMQ@@._V1._SY314_CR3,0,214,314_.jpg",1999,1093843-mansfield_park,6.9,66,50,16,75,6.3,18,10,8,55,3.6,6288,77,http://content9.flixster.com/movie/25/40/254095_det.jpg,-2
6064,The Harder They Fall,49291,Más dura será la caída,"http://ia.media-imdb.com/images/M/MV5BMTc2NjgxOTgwMF5BMl5BanBnXkFtZTcwMDg2NjMyMQ@@._V1._SY314_CR0,0,214,314_.jpg",1956,1009224-harder_they_fall,7.4,9,9,0,100,0,0,0,0,0,0,0,0,http://content9.flixster.com/movie/30/30/303099_det.jpg,100
5787,The Truth About Charlie,270707,La verdad sobre Charlie,"http://ia.media-imdb.com/images/M/MV5BMTQzNzc4NjE3OV5BMl5BanBnXkFtZTcwMTg3MTQyMQ@@._V1._SY293_CR1,0,214,293_.jpg",2002,truth_about_charlie,4.8,130,43,87,33,4.9,35,14,21,40,2.7,2359,29,http://content6.flixster.com/movie/10/88/84/10888428_det.jpg,4
7154,Mona Lisa Smile,304415,La sonrisa de Mona Lisa,"http://ia.media-imdb.com/images/M/MV5BMTM4Mzk1MTczNF5BMl5BanBnXkFtZTcwMjE1MTYyMQ@@._V1._SX214_CR0,0,214,314_.jpg",2003,mona_lisa_smile,4.9,147,51,96,34,5.2,41,18,23,43,3.1,23577,61,http://content9.flixster.com/movie/25/59/255923_det.jpg,-27
27664,The Brown Bunny,330099,The Brown Bunny,"http://ia.media-imdb.com/images/M/MV5BMTU2MzQ5NjMyNV5BMl5BanBnXkFtZTcwODYyODYyMQ@@._V1._SX214_CR0,0,214,314_.jpg",2003,brown_bunny,5.1,89,39,50,43,4.8,30,13,17,43,2.9,2486,48,http://content8.flixster.com/movie/10/88/57/10885774_det.jpg,-5
26303,The Banger Sisters,280460,Amigas a la fuerza,"http://ia.media-imdb.com/images/M/MV5BMTU2MjQ0OTM3N15BMl5BanBnXkFtZTcwOTQ0MjYyMQ@@._V1._SY314_CR3,0,214,314_.jpg",2002,banger_sisters,5.3,140,66,74,47,5.1,34,14,20,41,2.7,4139,45,http://content6.flixster.com/movie/27/44/274416_det.jpg,2
2444,24 7: Twenty Four Seven,120391,24 7: Twenty Four Seven,"http://ia.media-imdb.com/images/M/MV5BODY1NTQzMDQ0M15BMl5BanBnXkFtZTcwMTg5OTUxMQ@@._V1._SY314_CR3,0,214,314_.jpg",1997,twentyfourseven,5.7,20,7,13,35,5.6,5,1,4,20,3.9,451,84,http://content8.flixster.com/movie/10/87/22/10872274_det.jpg,-49
2296,A Night at the Roxbury,120770,Movida en el Roxbury,"http://ia.media-imdb.com/images/M/MV5BMTcyMDAzMDU0NV5BMl5BanBnXkFtZTcwMjI0OTM1MQ@@._V1._SY314_CR3,0,214,314_.jpg",1998,night_at_the_roxbury,3.4,54,6,48,11,2.6,11,0,11,0,3.1,27913,67,http://content7.flixster.com/movie/25/48/254893_det.jpg,-56
4516,Johnny Be Good,95409,Johnny superstar,"http://ia.media-imdb.com/images/M/MV5BMTg2NDU4NTUwMV5BMl5BanBnXkFtZTcwMjMzMjAwMQ@@._V1._SX214_CR0,0,214,314_.jpg",1988,johnny_be_good,2.3,11,0,11,0,0,3,0,3,0,2.6,1294,27,http://content7.flixster.com/movie/28/09/280909_det.jpg,-27
7131,A Summer Place,53320,"En una isla tranquila, al Sur","http://ia.media-imdb.com/images/M/MV5BMjE3MzkyMzUxNV5BMl5BanBnXkFtZTcwNzE3NjM0MQ@@._V1._SY314_CR23,0,214,314_.jpg",1959,summer_place,6,6,5,1,83,0,0,0,0,0,0,0,0,http://content7.flixster.com/movie/51/25/06/5125065_det.jpg,83
880,The Island of Dr. Moreau,116654,La isla del Dr. Moreau (Moreau's Island),"http://ia.media-imdb.com/images/M/MV5BMTIyMDI3NTI1OV5BMl5BanBnXkFtZTcwMDM2MjAyMQ@@._V1._SX214_CR0,0,214,314_.jpg",1996,1072156-island_of_dr_moreau,4.3,31,7,24,22,4,5,0,5,0,2.4,5032,26,http://content7.flixster.com/movie/28/70/287025_det.jpg,-4
7878,Straight to Hell,94048,Directos al infierno,"http://ia.media-imdb.com/images/M/MV5BMTM4MDQ2NTQyMl5BMl5BanBnXkFtZTcwNDI2NDAyMQ@@._V1._SY314_CR3,0,214,314_.jpg",1987,straight_to_hell,4.2,7,2,5,28,0,1,0,1,0,3.3,813,54,http://content7.flixster.com/movie/10/90/01/10900177_det.jpg,-26
5383,The Hound of the Baskervilles,52905,El perro de Baskervilles,"http://ia.media-imdb.com/images/M/MV5BMjE1NDc4MTQzMV5BMl5BanBnXkFtZTcwNDYzMTAzMQ@@._V1._SY314_CR3,0,214,314_.jpg",1959,1010004-hound_of_the_baskervilles,7.8,11,11,0,100,0,0,0,0,0,0,0,0,http://content6.flixster.com/movie/11/13/75/11137592_det.jpg,100
5072,Metropolis,17136,Metrópolis,"http://ia.media-imdb.com/images/M/MV5BMTI2ODk3ODIzNV5BMl5BanBnXkFtZTcwMDk0MTYxMQ@@._V1._SY314_CR9,0,214,314_.jpg",1927,1013775-metropolis,8.9,98,97,1,98,8.8,23,23,0,100,4.1,17640,90,http://content8.flixster.com/movie/10/93/38/10933866_det.jpg,8
3858,Cecil B. DeMented,173716,Cecil B. Demente,"http://ia.media-imdb.com/images/M/MV5BMTQ5MzczNTQzMl5BMl5BanBnXkFtZTYwOTA3Mzk4._V1._SX214_CR0,0,214,314_.jpg",2000,cecil_b_demented,5.6,78,40,38,51,4.4,24,8,16,33,3.4,2682,65,http://content9.flixster.com/movie/10/86/70/10867015_det.jpg,-14
33819,Heights,382073,En la cumbre,http://ia.media-imdb.com/images/M/MV5BMTQwNTgxMDA2MV5BMl5BanBnXkFtZTcwNTAxMDAzMQ@@._V1._SX203_SY300_.jpg,2005,heights,6.3,101,65,36,64,5.8,29,16,13,55,3.6,1284,73,http://content6.flixster.com/movie/26/71/267104_det.jpg,-9
4806,Obchod na korze,59527,La tienda de la calle Mayor,"http://ia.media-imdb.com/images/M/MV5BMTU1MzczNTMzOV5BMl5BanBnXkFtZTcwOTUzODcyMQ@@._V1._SY314_CR5,0,214,314_.jpg",1965,shop_on_main_street,8.9,12,12,0,100,0,0,0,0,0,0,0,0,http://content7.flixster.com/movie/10/88/19/10881997_det.jpg,100
869,Kansas City,116745,Kansas City,http://ia.media-imdb.com/images/M/MV5BMTczMjIyODA5OV5BMl5BanBnXkFtZTcwNTAzMzMzMQ@@._V1._SX200_SY288_.jpg,1996,kansas_city,5.9,33,19,14,57,6.2,9,5,4,55,3,608,37,http://content8.flixster.com/movie/28/25/282598_det.jpg,20
5539,Care Bears Movie II: A New Generation,90799,Care Bears Movie II: A New Generation,"http://ia.media-imdb.com/images/M/MV5BMTk5ODYzOTE0MF5BMl5BanBnXkFtZTcwMTkwMTQyMQ@@._V1._SY314_CR1,0,214,314_.jpg",1986,care_bears_movie_2_a_new_generation,0,0,0,0,0,0,0,0,0,0,0,0,0,http://content7.flixster.com/movie/10/94/34/10943409_det.jpg,0
2615,My Science Project,89652,My Science Project,"http://ia.media-imdb.com/images/M/MV5BNzI2MzcyNzg3NV5BMl5BanBnXkFtZTcwMjc3NjUyMQ@@._V1._SY314_CR5,0,214,314_.jpg",1985,my_science_project,3.2,5,1,4,20,0,0,0,0,0,0,0,0,http://content8.flixster.com/movie/26/60/266022_det.jpg,20
7581,The Fountainhead,41386,El manantial,"http://ia.media-imdb.com/images/M/MV5BMTUxMTY3ODYxMl5BMl5BanBnXkFtZTcwMzMxNDkzMQ@@._V1._SY314_CR21,0,214,314_.jpg",1949,fountainhead,6.4,11,9,2,81,0,0,0,0,0,0,0,0,http://content8.flixster.com/movie/10/85/56/10855630_det.jpg,81
2155,Slums of Beverly Hills,120831,Slums of Beverly Hills,"http://ia.media-imdb.com/images/M/MV5BNDI2OTY1NDU5MF5BMl5BanBnXkFtZTcwMTY2NzIzMQ@@._V1._SY314_CR7,0,214,314_.jpg",1998,slums_of_beverly_hills,6.9,58,46,12,79,7.3,13,12,1,92,3.3,1834,64,http://content6.flixster.com/movie/27/43/274320_det.jpg,15
5576,Les enfants du siècle,177746,Confesiones íntimas de una mujer,"http://ia.media-imdb.com/images/M/MV5BMTUxNjAyMzA4MF5BMl5BanBnXkFtZTcwNzQ5MzQyMQ@@._V1._SY314_CR4,0,214,314_.jpg",1999,children-of-the-century,5.2,42,18,24,42,5.4,12,5,7,41,3.6,422,71,http://content6.flixster.com/movie/11/15/07/11150796_det.jpg,-29
4438,Jing wu men,68767,Furia oriental,"http://ia.media-imdb.com/images/M/MV5BMTYxODIwNzcyMF5BMl5BanBnXkFtZTcwMzI5NzQzMQ@@._V1._SY314_CR7,0,214,314_.jpg",1972,laugh-track-the-chinese-connection,0,0,0,0,0,0,0,0,0,0,0,0,0,http://content9.flixster.com/movie/10/84/89/10848931_det.jpg,0
1005,D3: The Mighty Ducks,116000,D3: The Mighty Ducks,"http://ia.media-imdb.com/images/M/MV5BMTM2Njg5MDg4MF5BMl5BanBnXkFtZTcwNjk0MDcyMQ@@._V1._SY314_CR8,0,214,314_.jpg",1996,d3_the_mighty_ducks,3.7,14,2,12,14,0,4,0,4,0,2.8,9838,50,http://content7.flixster.com/movie/26/31/263193_det.jpg,-36
1298,Pink Floyd The Wall,84503,Pink Floyd The Wall,"http://ia.media-imdb.com/images/M/MV5BMTQxODgwODM2OV5BMl5BanBnXkFtZTcwNTAxMTMzMQ@@._V1._SY314_CR9,0,214,314_.jpg",1982,pink_floyd_the_wall,6.5,17,11,6,64,0,0,0,0,0,0,0,0,http://content8.flixster.com/movie/10/87/16/10871678_det.jpg,64
3667,Rent-a-Cop,95977,Rent-a-Cop,"http://ia.media-imdb.com/images/M/MV5BMjE4ODkxOTY4NV5BMl5BanBnXkFtZTcwMjk2MTQyMQ@@._V1._SX214_CR0,0,214,314_.jpg",1987,rentacop,3.8,11,2,9,18,0,1,0,1,0,2.3,601,19,http://content9.flixster.com/movie/10/91/99/10919991_det.jpg,-1
1017,Swiss Family Robinson,54357,Los robinsones de los mares del Sur,"http://ia.media-imdb.com/images/M/MV5BMTI3MjY5NzcwNF5BMl5BanBnXkFtZTYwNTg2MDY5._V1._SX214_CR0,0,214,314_.jpg",1960,1020736-swiss_family_robinson,6.7,17,14,3,82,0,2,1,1,50,3.3,3986,71,http://content8.flixster.com/movie/10/86/95/10869530_det.jpg,11
4801,The Little Foxes,33836,La loba,"http://ia.media-imdb.com/images/M/MV5BMTk5MDY1NjUyOF5BMl5BanBnXkFtZTcwMDA5MjMyMQ@@._V1._SX214_CR0,0,214,314_.jpg",1941,little_foxes,8.5,14,14,0,100,0,0,0,0,0,0,0,0,http://content6.flixster.com/movie/29/31/293120_det.jpg,100
4502,Ernest Saves Christmas,95107,Ernest Saves Christmas,"http://ia.media-imdb.com/images/M/MV5BMTY0OTMwMTAxM15BMl5BanBnXkFtZTcwMjQwNTMyMQ@@._V1._SY314_CR3,0,214,314_.jpg",1988,ernest_saves_christmas,4.7,13,5,8,38,0,0,0,0,0,0,0,0,http://content7.flixster.com/movie/25/55/255517_det.jpg,38
33679,Mr. & Mrs. Smith,356910,Mr. y Mrs. Smith,"http://ia.media-imdb.com/images/M/MV5BMTUxMzcxNzQzOF5BMl5BanBnXkFtZTcwMzQxNjUyMw@@._V1._SX214_CR0,0,214,314_.jpg",2005,mr_and_mrs_smith,6,202,116,86,57,5.6,39,18,21,46,3.4,230941,63,http://content8.flixster.com/movie/24/98/249802_det.jpg,-6
56805,Walk Hard: The Dewey Cox Story,841046,Dewey Cox - Una vida larga y dura,"http://ia.media-imdb.com/images/M/MV5BMTk5NDMyNTk0N15BMl5BanBnXkFtZTcwMTQ4MDUzMw@@._V1._SX214_CR0,0,214,314_.jpg",2007,walk_hard,6.6,137,102,35,74,6.1,34,25,9,73,3.1,58871,55,http://content8.flixster.com/movie/10/89/74/10897410_det.jpg,19
1509,Walk All Over Me,907680,Walk All Over Me,"http://ia.media-imdb.com/images/M/MV5BMjc2MTYzOTMyOF5BMl5BanBnXkFtZTcwOTIzMDU1MQ@@._V1._SX214_CR0,0,214,314_.jpg",2007,1194274-walk_all_over_me,0,4,2,2,50,0,1,0,1,0,3,609,37,http://content6.flixster.com/movie/10/91/88/10918812_det.jpg,13
4961,Porn Star: The Legend of Ron Jeremy,282856,Porn Star: The Legend of Ron Jeremy,"http://ia.media-imdb.com/images/M/MV5BNDgwNzczMjgyM15BMl5BanBnXkFtZTcwMDI2MTYyMQ@@._V1._SX214_CR0,0,214,314_.jpg",2001,porn_star_the_legend_of_ron_jeremy,6,47,32,15,68,5.5,17,8,9,47,3.3,1190,61,http://content9.flixster.com/movie/10/91/20/10912015_det.jpg,7
26870,Major League II,110442,Major League II,"http://ia.media-imdb.com/images/M/MV5BMTk4OTkwODY1N15BMl5BanBnXkFtZTcwOTUxNDcxMQ@@._V1._SX214_CR0,0,214,314_.jpg",1994,major_league_2,3.3,21,1,20,4,2.7,6,0,6,0,2.8,4428,45,http://content8.flixster.com/movie/25/67/256714_det.jpg,-41
6147,Die weiße Rose,84897,Die weiße Rose,"http://ia.media-imdb.com/images/M/MV5BMTI5NTA5NTU3OV5BMl5BanBnXkFtZTcwMjQ4MDAyMQ@@._V1._SX214_CR0,0,214,314_.jpg",1982,white_rose,0,0,0,0,0,0,0,0,0,0,0,0,0,http://content9.flixster.com/movie/10/88/94/10889431_det.jpg,0
1216,Le grand bleu,95250,El gran azul,"http://ia.media-imdb.com/images/M/MV5BMjAwNDg5NzgzN15BMl5BanBnXkFtZTcwMjAxODgxMQ@@._V1._SY314_CR2,0,214,314_.jpg",1988,1002303-big_blue,5.8,12,8,4,66,0,2,0,2,0,4.1,10653,92,http://content9.flixster.com/movie/10/94/57/10945723_det.jpg,-26
7487,Henry & June,99762,Henry & June,"http://ia.media-imdb.com/images/M/MV5BMjA3NzIxNTA0Ml5BMl5BanBnXkFtZTcwNzk5NjMyMQ@@._V1._SY314_CR3,0,214,314_.jpg",1990,henry_and_june,6,14,9,5,64,0,1,1,0,100,3.5,2170,67,http://content6.flixster.com/movie/28/56/285600_det.jpg,-3
3040,Meatballs,79540,Los incorregibles albóndigas,"http://ia.media-imdb.com/images/M/MV5BMjAyNTM0ODMzMl5BMl5BanBnXkFtZTcwMTU1NDY0MQ@@._V1._SY314_CR2,0,214,314_.jpg",1979,meatballs,6.2,28,20,8,71,0,3,2,1,66,3,3676,54,http://content8.flixster.com/movie/55/06/08/5506086_det.jpg,17
3506,North Dallas Forty,79640,North Dallas Forty,"http://ia.media-imdb.com/images/M/MV5BMTg3NjE4NTAzOF5BMl5BanBnXkFtZTcwMDk5MjUxMQ@@._V1._SY314_CR2,0,214,314_.jpg",1979,north_dallas_forty,6.6,20,17,3,85,0,4,4,0,100,3.4,594,69,http://content9.flixster.com/movie/27/09/270991_det.jpg,16
41575,Wu ji,417976,La promesa,"http://ia.media-imdb.com/images/M/MV5BMjgwNDM1NTY2NF5BMl5BanBnXkFtZTcwNjc4NDUzMQ@@._V1._SX214_CR0,0,214,314_.jpg",2005,1154356-promise,5.2,77,24,53,31,5.2,26,11,15,42,2.9,11585,41,http://content7.flixster.com/movie/10/86/15/10861597_det.jpg,-10
4713,Altered States,80360,Un viaje alucinante al fondo de la mente,"http://ia.media-imdb.com/images/M/MV5BMjAzMTA1NDU1MF5BMl5BanBnXkFtZTcwMDUzODcxMQ@@._V1._SY314_CR5,0,214,314_.jpg",1980,altered_states,6.9,33,29,4,87,0,4,4,0,100,3.4,4339,66,http://content9.flixster.com/movie/27/12/271295_det.jpg,21
8811,Yûgiô Duel Monsters: Hikari no pyramid,403703,¡Yu-Gi-Oh!: La película,http://ia.media-imdb.com/images/M/MV5BMTg4OTg1NDQ2NF5BMl5BanBnXkFtZTcwMjM4NzUyMQ@@._V1._SX134_SY199_.jpg,2004,yugioh,3,62,3,59,4,2.8,19,0,19,0,3,2474,53,http://content9.flixster.com/movie/10/92/94/10929463_det.jpg,-49
48856,A Guide to Recognizing Your Saints,473488,Memorias de Queens,"http://ia.media-imdb.com/images/M/MV5BNjk4MzIyMzUxMV5BMl5BanBnXkFtZTcwNTk4NTU0MQ@@._V1._SY314_CR4,0,214,314_.jpg",2006,a_guide_to_recognizing_your_saints,6.6,93,70,23,75,6.3,28,19,9,67,3.3,23093,67,http://content8.flixster.com/movie/10/92/97/10929790_det.jpg,8
50796,Blood and Chocolate,397044,La marca del lobo,"http://ia.media-imdb.com/images/M/MV5BMTc5MjU4MTI2Ml5BMl5BanBnXkFtZTcwMDcxMzY0MQ@@._V1._SY314_CR2,0,214,314_.jpg",2007,blood_and_chocolate,3.6,73,8,65,10,3.3,17,1,16,5,3.1,38058,56,http://content6.flixster.com/movie/10/89/25/10892520_det.jpg,-46
892,Twelfth Night,117991,Noche de reyes o lo que queráis,"http://ia.media-imdb.com/images/M/MV5BMTU1ODA5MjY0MV5BMl5BanBnXkFtZTcwMjExNDMzMQ@@._V1._SY314_CR4,0,214,314_.jpg",1996,twelfth-night,6.8,30,21,9,70,6.5,10,7,3,70,3.7,1937,77,http://content9.flixster.com/movie/10/89/35/10893535_det.jpg,-7
7094,The Rules of Attraction,292644,Las reglas del juego,"http://ia.media-imdb.com/images/M/MV5BMTk4ODA4MzE4OV5BMl5BanBnXkFtZTYwNTc1Mzg5._V1._SY314_CR1,0,214,314_.jpg",2002,rules_of_attraction,5.3,134,59,75,44,4.9,27,9,18,33,3.2,10253,71,http://content8.flixster.com/movie/26/92/269226_det.jpg,-27
5525,Bella Martha,246772,Deliciosa Martha,"http://ia.media-imdb.com/images/M/MV5BNTQ4MTIxNjk4NV5BMl5BanBnXkFtZTcwMTYwODYxMQ@@._V1._SX214_CR0,0,214,314_.jpg",2001,mostly_martha,7.2,82,75,7,91,7,25,22,3,88,4,2477,88,http://content7.flixster.com/movie/10/92/31/10923101_det.jpg,3
7366,Jersey Girl,300051,Una chica de Jersey,"http://ia.media-imdb.com/images/M/MV5BMTQyMjU0MzczNV5BMl5BanBnXkFtZTcwNTQ1NTYyMQ@@._V1._SY314_CR3,0,214,314_.jpg",2004,jersey_girl,5.3,169,69,100,40,4.7,38,12,26,31,2.9,16772,52,http://content8.flixster.com/movie/10/86/10/10861010_det.jpg,-12
2931,Dom za vesanje,97223,El tiempo de los gitanos,"http://ia.media-imdb.com/images/M/MV5BMTM4MjY1NTAwOV5BMl5BanBnXkFtZTcwMDkyNjEyMQ@@._V1._SX214_CR0,0,214,314_.jpg",1988,a-time-of-gypsies-dom-za-vesanje,7.1,5,5,0,100,0,2,2,0,100,4.5,2705,96,http://content8.flixster.com/movie/10/86/20/10862022_det.jpg,4
3109,Frozen River,978759,Frozen River,"http://ia.media-imdb.com/images/M/MV5BMTk2NjMwMDgzNF5BMl5BanBnXkFtZTcwMDY0NDY3MQ@@._V1._SX214_CR0,0,214,314_.jpg",2008,frozen_river,7.3,125,109,16,87,7.9,26,24,2,92,3.2,9338,71,http://content6.flixster.com/movie/10/93/37/10933756_det.jpg,16
1476,Private Parts,119951,Partes privadas,"http://ia.media-imdb.com/images/M/MV5BMTg5NTk5NDU1Nl5BMl5BanBnXkFtZTcwODQwMjEyMQ@@._V1._SY314_CR3,0,214,314_.jpg",1997,private-parts,0,0,0,0,0,0,0,0,0,0,0,0,0,http://content7.flixster.com/movie/10/92/42/10924221_det.jpg,0
486,Life with Mikey,107413,¡Dadme un respiro!,"http://ia.media-imdb.com/images/M/MV5BMTg1NTk2ODMwOV5BMl5BanBnXkFtZTcwOTY4NTUyMQ@@._V1._SY314_CR7,0,214,314_.jpg",1993,life_with_mikey,3.9,9,2,7,22,0,2,0,2,0,2.8,1377,39,http://content9.flixster.com/movie/26/48/264827_det.jpg,-17
2282,Pecker,126604,Pecker,"http://ia.media-imdb.com/images/M/MV5BMTU4NTYxOTM1MF5BMl5BanBnXkFtZTcwNzc5OTkxMQ@@._V1._SX214_CR0,0,214,314_.jpg",1998,pecker,5.7,43,23,20,53,4.7,6,1,5,16,3.2,3201,63,http://content9.flixster.com/movie/10/03/99/10039927_det.jpg,-10
5717,Cannibal ferox,82700,Caníbal feroz,"http://ia.media-imdb.com/images/M/MV5BMjExODYwMTUzOF5BMl5BanBnXkFtZTcwMTM0MTA0MQ@@._V1._SY314_CR6,0,214,314_.jpg",1981,cannibal_ferox,0,3,0,3,0,0,0,0,0,0,0,0,0,http://content7.flixster.com/movie/97/82/79/9782797_det.jpg,0
1613,Star Maps,120197,Los Ángeles gigoló,"http://ia.media-imdb.com/images/M/MV5BMTQ3NTU2NzQyMl5BMl5BanBnXkFtZTcwODk1MjYxMQ@@._V1._SX214_CR0,0,214,314_.jpg",1997,star_maps,5,15,5,10,33,0,4,0,4,0,3.1,60,44,http://content9.flixster.com/movie/10/85/19/10851963_det.jpg,-11
40732,The Descent,435625,El descenso,"http://ia.media-imdb.com/images/M/MV5BMjA5NzQ1NTgwNV5BMl5BanBnXkFtZTcwNjUxMzUzMw@@._V1._SX214_CR0,0,214,314_.jpg",2005,descent,7.3,165,139,26,84,7,30,22,8,73,3.3,49487,71,http://content7.flixster.com/movie/11/14/69/11146933_det.jpg,13
6818,Idi i smotri,91251,Masacre (ven y mira),"http://ia.media-imdb.com/images/M/MV5BMTMzNDA0MjA4M15BMl5BanBnXkFtZTcwMzI2NzAzMQ@@._V1._SY314_CR1,0,214,314_.jpg",1985,1036052-come_and_see,8,20,19,1,95,0,4,3,1,75,4.5,2288,96,http://content8.flixster.com/movie/30/95/309526_det.jpg,-1
8798,Collateral,369339,Collateral,"http://ia.media-imdb.com/images/M/MV5BMjE3NjM5OTMxMV5BMl5BanBnXkFtZTcwOTIzMTQyMw@@._V1._SX214_CR0,0,214,314_.jpg",2004,collateral,7.4,223,192,31,86,7.2,44,36,8,81,3.5,43901,79,http://content6.flixster.com/movie/10/93/72/10937228_det.jpg,7
6764,The Rundown,327850,El tesoro del Amazonas,"http://ia.media-imdb.com/images/M/MV5BMTY5MDQ3NDMwNV5BMl5BanBnXkFtZTcwNjc2MTYyMQ@@._V1._SX214_CR0,0,214,314_.jpg",2003,rundown,6.4,143,102,41,71,6.1,31,20,11,64,3.3,18070,72,http://content8.flixster.com/movie/10/58/45/10584506_det.jpg,-1
2256,Parasite,84472,Parasite,"http://ia.media-imdb.com/images/M/MV5BMTQ3NzYyNTA3NF5BMl5BanBnXkFtZTcwNzY2NzEyMQ@@._V1._SY314_CR2,0,214,314_.jpg",1982,1015940-parasite,2.2,5,0,5,0,0,0,0,0,0,0,0,0,http://content6.flixster.com/movie/10/86/97/10869728_det.jpg,0
6005,Blue Collar Comedy Tour: The Movie,330069,Blue Collar Comedy Tour: The Movie,"http://ia.media-imdb.com/images/M/MV5BMTQyNzY0ODA4Ml5BMl5BanBnXkFtZTYwOTc3MTg5._V1._SX214_CR0,0,214,314_.jpg",2003,blue_collar_comedy_tour_the_movie,6.8,13,12,1,92,7,8,8,0,100,3.6,6829,82,http://content6.flixster.com/movie/10/89/21/10892104_det.jpg,10
45221,Stick It,430634,¡Que les den!,"http://ia.media-imdb.com/images/M/MV5BMTU3OTAyNzE4N15BMl5BanBnXkFtZTcwNzg3MDUzMQ@@._V1._SY314_CR5,0,214,314_.jpg",2006,stick_it,4.9,96,30,66,31,5,25,9,16,36,3.5,82123,76,http://content8.flixster.com/movie/31/40/314026_det.jpg,-45
47642,How to Eat Fried Worms,462346,How to Eat Fried Worms,"http://ia.media-imdb.com/images/M/MV5BMTc0MzgwNjcyOV5BMl5BanBnXkFtZTcwNjE3ODQzMQ@@._V1._SX214_CR0,0,214,314_.jpg",2006,how_to_eat_fried_worms,6,71,41,30,57,5.8,25,13,12,52,3,15503,51,http://content8.flixster.com/movie/10/91/74/10917454_det.jpg,6
5461,Me Without You,263725,No soy nadie sin ti,"http://ia.media-imdb.com/images/M/MV5BMTY1OTc3ODIzNV5BMl5BanBnXkFtZTcwMzg0NDAyMQ@@._V1._SY314_CR5,0,214,314_.jpg",2001,me_without_you,6.2,65,43,22,66,6.3,22,16,6,72,3.8,1522,78,http://content8.flixster.com/movie/10/88/45/10884586_det.jpg,-12
51082,Daddy's Little Girls,778661,Daddy's Little Girls,"http://ia.media-imdb.com/images/M/MV5BMTYyMDIzMDUzMV5BMl5BanBnXkFtZTcwMjQ4ODQ0MQ@@._V1._SX214_CR0,0,214,314_.jpg",2007,daddys_little_girls,4.8,52,14,38,26,5.4,20,8,12,40,3.9,88879,80,http://content7.flixster.com/movie/10/87/66/10876637_det.jpg,-54
5477,Lucía y el sexo,254455,Lucía y el sexo,"http://ia.media-imdb.com/images/M/MV5BMTIxMTAwMDgyMV5BMl5BanBnXkFtZTcwMDE3NTgyMQ@@._V1._SY314_CR3,0,214,314_.jpg",2001,sex_and_lucia,6.5,69,49,20,71,5.8,20,12,8,60,3.9,6145,85,http://content9.flixster.com/movie/10/89/48/10894831_det.jpg,-14
4984,Morgan: A Suitable Case for Treatment,60714,"Morgan, un caso clínico","http://ia.media-imdb.com/images/M/MV5BODI0MjIxOTQ1OF5BMl5BanBnXkFtZTcwMzA0MTgxMQ@@._V1._SY314_CR3,0,214,314_.jpg",1966,morgan,7.3,6,6,0,100,0,0,0,0,0,0,0,0,http://content6.flixster.com/movie/30/58/305812_det.jpg,100
7376,Walking Tall,351977,Pisando fuerte,http://ia.media-imdb.com/images/M/MV5BNjQ5NjgwNDA3NF5BMl5BanBnXkFtZTcwNzM3OTQyMQ@@._V1._SX134_SY193_.jpg,2004,walking_tall,4.4,130,32,98,24,4.6,34,7,27,20,3.2,20192,71,http://content6.flixster.com/movie/11/14/56/11145672_det.jpg,-47
6601,Big Trouble,246464,El gran lío,"http://ia.media-imdb.com/images/M/MV5BMTIzMjQyMzgwMV5BMl5BanBnXkFtZTcwODM0ODkxMQ@@._V1._SY314_CR8,0,214,314_.jpg",2002,1109942-big_trouble,5.4,110,53,57,48,4.8,31,9,22,29,2.9,3337,52,http://content9.flixster.com/movie/10/92/12/10921251_det.jpg,-4
43899,Tony Takitani,420260,Tony Takitani,"http://ia.media-imdb.com/images/M/MV5BMTMzOTY1NDAwMl5BMl5BanBnXkFtZTcwMzY1MTUzMQ@@._V1._SY314_CR4,0,214,314_.jpg",2004,tony_takitani,7.4,52,46,6,88,8.1,17,17,0,100,3.9,1083,80,http://content9.flixster.com/movie/30/25/54/3025547_det.jpg,8
7377,The United States of Leland,301976,El mundo de Leland,"http://ia.media-imdb.com/images/M/MV5BMTk4NjgyNzgyNl5BMl5BanBnXkFtZTcwMDU3MTUyMQ@@._V1._SX214_CR0,0,214,314_.jpg",2003,united_states_of_leland,4.9,87,29,58,33,4.5,27,7,20,25,3.8,6163,83,http://content7.flixster.com/movie/26/99/269913_det.jpg,-50
8739,Mamma Roma,56215,Mamma Roma,"http://ia.media-imdb.com/images/M/MV5BMTc4MzE5OTEyNV5BMl5BanBnXkFtZTcwNDM0ODUyMQ@@._V1._SY314_CR5,0,214,314_.jpg",1962,mamma_roma,7.8,9,9,0,100,0,0,0,0,0,0,0,0,http://content9.flixster.com/movie/10/93/52/10935271_det.jpg,100
8195,L'avventura,53619,La aventura,"http://ia.media-imdb.com/images/M/MV5BMTMyODM1Mjg2MF5BMl5BanBnXkFtZTcwMDI5ODIyMQ@@._V1._SY314_CR5,0,214,314_.jpg",1960,lavventura,8.6,26,25,1,96,0,3,3,0,100,4.2,3223,90,http://content7.flixster.com/movie/29/31/293117_det.jpg,6
7184,This Property Is Condemned,61089,Propiedad condenada,"http://ia.media-imdb.com/images/M/MV5BMTU5OTEyNDc4OV5BMl5BanBnXkFtZTcwMjAwNTAwMQ@@._V1._SY314_CR4,0,214,314_.jpg",1966,this_property_is_condemned,5.5,14,9,5,64,0,3,2,1,66,3.8,780,75,http://content7.flixster.com/movie/28/65/286505_det.jpg,-11
6216,Nirgendwo in Afrika,161860,En un lugar de África,"http://ia.media-imdb.com/images/M/MV5BMTc5MjYyMTcyM15BMl5BanBnXkFtZTcwMDU1NzAyMQ@@._V1._SY314_CR1,0,214,314_.jpg",2001,nowhere-in-africa,7.5,97,83,14,85,7.6,30,25,5,83,4,1773,88,http://content6.flixster.com/movie/10/93/76/10937636_det.jpg,-3
2648,Frankenstein,21884,El doctor Frankenstein,"http://ia.media-imdb.com/images/M/MV5BMjAyNDA0NTI3OF5BMl5BanBnXkFtZTcwMDc3Nzc3Mw@@._V1._SX214_CR0,0,214,314_.jpg",1931,1007818-frankenstein,8.5,38,38,0,100,7.8,5,5,0,100,3.6,7211,81,http://content8.flixster.com/movie/28/83/288310_det.jpg,19
31804,Nochnoy dozor,403358,Guardianes de la noche,"http://ia.media-imdb.com/images/M/MV5BMjE0Nzk0NDkyOV5BMl5BanBnXkFtZTcwMjkzOTkyMQ@@._V1._SX214_CR0,0,214,314_.jpg",2004,1148279-night_watch,5.9,125,73,52,58,5.9,30,17,13,56,3.3,19774,70,http://content8.flixster.com/movie/22/60/07/2260074_det.jpg,-12
1291,Indiana Jones and the Last Crusade,97576,Indiana Jones y la última cruzada,"http://ia.media-imdb.com/images/M/MV5BMTkwNjQwMjgxNl5BMl5BanBnXkFtZTcwMDg4MzM2MQ@@._V1._SY314_CR4,0,214,314_.jpg",1989,indiana_jones_and_the_last_crusade,7.9,54,48,6,88,6.5,7,5,2,71,3.9,103952,91,http://content7.flixster.com/movie/10/91/96/10919621_det.jpg,-3
5132,The Last Man on Earth,58700,The Last Man on Earth,"http://ia.media-imdb.com/images/M/MV5BMjA2ODMwNTAwN15BMl5BanBnXkFtZTcwMjg1MDU1MQ@@._V1._SY314_CR7,0,214,314_.jpg",1964,1050388-last_man_on_earth,6.3,15,11,4,73,0,1,0,1,0,3.6,4886,69,http://content7.flixster.com/movie/18/68/33/1868337_det.jpg,4
4101,Dogs in Space,92904,Dogs in Space,"http://ia.media-imdb.com/images/M/MV5BMTM0NjcwMTYyNF5BMl5BanBnXkFtZTcwNzg1MDcyMQ@@._V1._SY314_CR8,0,214,314_.jpg",1986,dogs_in_space,0,2,1,1,50,0,0,0,0,0,0,0,0,http://content9.flixster.com/movie/40/82/26/4082263_det.jpg,50
4593,Family Business,97328,Negocios de familia,"http://ia.media-imdb.com/images/M/MV5BMTgyODc4MjE3MF5BMl5BanBnXkFtZTcwMTMzMDIyMQ@@._V1._SY314_CR1,0,214,314_.jpg",1989,family_business,5.1,15,6,9,40,0,1,1,0,100,2.8,1601,28,http://content6.flixster.com/movie/27/65/276512_det.jpg,12
26198,"Yours, Mine and Ours",443295,"Mios, tuyos y nuestros","http://ia.media-imdb.com/images/M/MV5BMTYwNjM1MDQ4N15BMl5BanBnXkFtZTcwMzM3NjIzMQ@@._V1._SY314_CR13,0,214,314_.jpg",2005,yours_mine_and_ours,3.3,105,6,99,5,3.7,28,1,27,3,3.2,36270,64,http://content6.flixster.com/movie/25/06/250608_det.jpg,-59
4967,No Man's Land,283509,En tierra de nadie,"http://ia.media-imdb.com/images/M/MV5BMTY0MjUwNjA5OF5BMl5BanBnXkFtZTYwNDAxMjc5._V1._SY314_CR2,0,214,314_.jpg",2001,no_mans_land,7.8,97,90,7,92,8.2,24,23,1,95,4.1,3608,92,http://content9.flixster.com/movie/27/16/271623_det.jpg,0
1895,Can't Hardly Wait,127723,Ya no puedo esperar,"http://ia.media-imdb.com/images/M/MV5BMjAyMTUzODg2OV5BMl5BanBnXkFtZTcwMjM4MTAyMQ@@._V1._SX214_CR0,0,214,314_.jpg",1998,cant_hardly_wait,5.4,45,20,25,44,5.4,12,5,7,41,3.1,11719,60,http://content9.flixster.com/movie/25/65/256595_det.jpg,-16
3204,The Boys from Brazil,77269,Los niños del Brasil,"http://ia.media-imdb.com/images/M/MV5BNTMyNzkyNTk0OV5BMl5BanBnXkFtZTcwNzI0MTQyMQ@@._V1._SX214_CR0,0,214,314_.jpg",1978,1002993-boys_from_brazil,6.2,26,17,9,65,0,2,0,2,0,3.5,1963,68,http://content7.flixster.com/movie/10/90/11/10901117_det.jpg,-3
27564,Sex Is Comedy,304678,Sex Is Comedy,"http://ia.media-imdb.com/images/M/MV5BMTkwNjY0ODAwN15BMl5BanBnXkFtZTcwMTk2ODcyMQ@@._V1._SY314_CR8,0,214,314_.jpg",2002,sex_is_comedy,6.4,46,32,14,69,6.5,19,12,7,63,3.1,1109,52,http://content8.flixster.com/movie/10/08/28/10082818_det.jpg,17
1923,There's Something About Mary,129387,Algo pasa con Mary,"http://ia.media-imdb.com/images/M/MV5BMjA0OTU2MzYwOV5BMl5BanBnXkFtZTYwNTA3OTk5._V1._SY314_CR3,0,214,314_.jpg",1998,something_more,0,2,0,2,0,0,1,0,1,0,3.1,233,47,http://content7.flixster.com/movie/10/88/61/10886109_det.jpg,-47
8129,Sex: The Annabel Chong Story,181810,Sex: The Annabel Chong Story,"http://ia.media-imdb.com/images/M/MV5BOTM1Njc5MDUzNl5BMl5BanBnXkFtZTcwNjc1NjkxMQ@@._V1._SY314_CR1,0,214,314_.jpg",1999,sex_the_annabel_chong_story,5.1,17,7,10,41,0,4,2,2,50,3.1,1360,51,http://content6.flixster.com/movie/30/26/302628_det.jpg,-10
2320,Apt Pupil,118636,Verano de corrupción,"http://ia.media-imdb.com/images/M/MV5BMTQzOTA5OTQxOV5BMl5BanBnXkFtZTcwOTk1MjIyMQ@@._V1._SY314_CR3,0,214,314_.jpg",1998,apt_pupil,6,55,29,26,52,5.5,14,7,7,50,3.1,5334,57,http://content8.flixster.com/movie/27/24/272414_det.jpg,-5
7245,Hets,36914,Tortura,"http://ia.media-imdb.com/images/M/MV5BMTM0OTgxNjI0Nl5BMl5BanBnXkFtZTcwNzQ0NDEyMQ@@._V1._SX214_CR0,0,214,314_.jpg",1944,1021711-torment,7,6,5,1,83,0,2,1,1,50,3.8,348,76,http://content8.flixster.com/movie/54/91/18/5491186_det.jpg,7
7702,The Bells of St. Mary's,37536,Las campanas de Santa María,"http://ia.media-imdb.com/images/M/MV5BMTY1NjU1MzUzNF5BMl5BanBnXkFtZTcwMTkwNDgxMQ@@._V1._SX214_CR0,0,214,314_.jpg",1945,bells_of_st_marys,7.2,15,14,1,93,0,3,3,0,100,3.7,1566,76,http://content8.flixster.com/movie/29/08/290898_det.jpg,17
7063,"Aguirre, der Zorn Gottes",68182,"Aguirre, la cólera de dios","http://ia.media-imdb.com/images/M/MV5BNDU5ODY4ODY5Ml5BMl5BanBnXkFtZTcwODA2NTUyMQ@@._V1._SX214_CR0,0,214,314_.jpg",1972,aguirre_the_wrath_of_god,8.9,32,31,1,96,0,3,3,0,100,4.2,6781,91,http://content8.flixster.com/movie/29/36/293618_det.jpg,5
59107,The Life Before Her Eyes,815178,La vida ante sus ojos,"http://ia.media-imdb.com/images/M/MV5BMTM1MzAxNzgyM15BMl5BanBnXkFtZTcwNjAyOTM2MQ@@._V1._SX214_CR0,0,214,314_.jpg",2007,life_before_her_eyes,4.4,91,22,69,24,4.8,21,7,14,33,3.3,6082,55,http://content9.flixster.com/movie/10/91/33/10913323_det.jpg,-31
1908,Resurrection Man,140508,Resurrection Man,"http://ia.media-imdb.com/images/M/MV5BMTQyNDE0MDQyOF5BMl5BanBnXkFtZTcwODg3NDYyMQ@@._V1._SY314_CR4,0,214,314_.jpg",1998,resurrection_man,0,3,0,3,0,0,0,0,0,0,0,0,0,http://content7.flixster.com/movie/10/92/14/10921409_det.jpg,0
3768,Braddock: Missing in Action III,94792,Braddock: Desaparecido en combate 3,"http://ia.media-imdb.com/images/M/MV5BMTMxODI3NjYxMl5BMl5BanBnXkFtZTcwNTc0MjEyMQ@@._V1._SY314_CR3,0,214,314_.jpg",1988,braddock_missing_in_action_3,0,0,0,0,0,0,0,0,0,0,0,0,0,http://content6.flixster.com/movie/62/57/87/6257876_det.jpg,0
40414,Joyeux Noël,424205,Joyeux Noël,"http://ia.media-imdb.com/images/M/MV5BMTQyODczNjU3NF5BMl5BanBnXkFtZTcwNjQ0NDIzMQ@@._V1._SX214_CR0,0,214,314_.jpg",2005,joyeux_noel,6.8,91,69,22,75,7.1,26,22,4,84,3.6,9688,80,http://content9.flixster.com/movie/31/28/312815_det.jpg,-5
2022,The Last Temptation of Christ,95497,La última tentación de Cristo,"http://ia.media-imdb.com/images/M/MV5BNzA1NDYzNjA4MF5BMl5BanBnXkFtZTYwOTYzMDg4._V1._SY314_CR5,0,214,314_.jpg",1988,last_temptation_of_christ,7.3,46,38,8,82,7.5,7,6,1,85,3.7,7365,83,http://content8.flixster.com/movie/27/03/270314_det.jpg,-1
8913,Around the Bend,384810,A la vuelta de la esquina,"http://ia.media-imdb.com/images/M/MV5BMTY4NDE5ODIxNl5BMl5BanBnXkFtZTcwNjM4OTYyMQ@@._V1._SX214_CR0,0,214,314_.jpg",2004,around_the_bend,4.9,94,27,67,28,4.7,30,7,23,23,3.4,1012,65,http://content9.flixster.com/movie/10/88/98/10889891_det.jpg,-37
2627,The Endurance: Shackleton's Legendary Antarctic Expedition,264578,The Endurance: Shackleton's Legendary Antarctic Expedition,"http://ia.media-imdb.com/images/M/MV5BMTQ4NTkwNDcxNl5BMl5BanBnXkFtZTcwMDcwODcyMQ@@._V1._SY314_CR1,0,214,314_.jpg",2000,the-endurance,7.7,65,62,3,95,7.9,24,24,0,100,3.8,415,79,http://content7.flixster.com/movie/25/13/251325_det.jpg,16
40,"Cry, the Beloved Country",112749,Llanto por la tierra amada,"http://ia.media-imdb.com/images/M/MV5BMTcwMDU1OTEwOF5BMl5BanBnXkFtZTcwMTg5NjEyMQ@@._V1._SY314_CR3,0,214,314_.jpg",1995,1068781-cry_the_beloved_country,7.2,13,10,3,76,0,4,3,1,75,3.5,520,66,http://content6.flixster.com/movie/10/89/59/10895996_det.jpg,10
63806,Ring of Darkness,372803,Ring of Darkness,"http://ia.media-imdb.com/images/M/MV5BMjAyOTE1MzI0N15BMl5BanBnXkFtZTcwNzMxMTgyMQ@@._V1._SY314_CR3,0,214,314_.jpg",2004,ring_of_darkness,0,0,0,0,0,0,0,0,0,0,0,0,0,http://content7.flixster.com/movie/28/02/280297_det.jpg,0
1906,Mr. Jealousy,119717,Mr. Jealousy,"http://ia.media-imdb.com/images/M/MV5BMTYzNTg4OTU1M15BMl5BanBnXkFtZTcwODM0NzkxMQ@@._V1._SY314_CR5,0,214,314_.jpg",1997,mr_jealousy,6.5,12,8,4,66,0,4,2,2,50,3.3,437,59,http://content7.flixster.com/movie/28/00/280097_det.jpg,7
6547,Northfork,322659,Northfork,"http://ia.media-imdb.com/images/M/MV5BMTcxNDUwMTUwMF5BMl5BanBnXkFtZTcwMjU1MTYyMQ@@._V1._SX214_CR0,0,214,314_.jpg",2003,northfork,5.9,99,56,43,56,5.6,32,16,16,50,3.5,992,68,http://content9.flixster.com/movie/26/09/260927_det.jpg,-12
3438,Teenage Mutant Ninja Turtles,100758,Tortugas ninja,http://ia.media-imdb.com/images/M/MV5BMTIxMjgxNTUyNV5BMl5BanBnXkFtZTYwMDA4Mjg5._V1._SX144_SY222_.jpg,1990,teenage_mutant_ninja_turtles_the_movie,4.9,37,17,20,45,5.8,7,4,3,57,3.3,21473,76,http://content7.flixster.com/movie/25/56/255697_det.jpg,-31
757,Dung che sai duk,1233247,Este contraveneno del Oeste,"http://ia.media-imdb.com/images/M/MV5BMTc0NzMxMjI0MV5BMl5BanBnXkFtZTcwNzIwNzM5MQ@@._V1._SX214_CR0,0,214,314_.jpg",1994,ashes_of_time_redux,6.6,69,54,15,78,6.7,18,14,4,77,3.6,2166,71,http://content8.flixster.com/movie/10/93/19/10931906_det.jpg,7
4103,Empire of the Sun,92965,El imperio del Sol,"http://ia.media-imdb.com/images/M/MV5BMTI1Nzk0MjI5Ml5BMl5BanBnXkFtZTYwMDc1NDc5._V1._SY314_CR1,0,214,314_.jpg",1987,empire_of_the_sun,6.8,35,28,7,80,5.7,6,3,3,50,3.9,15781,88,http://content9.flixster.com/movie/25/43/254399_det.jpg,-8
7761,La peau douce,58458,La piel suave,http://ia.media-imdb.com/images/M/MV5BMTQ2NjE3MjIwNV5BMl5BanBnXkFtZTcwNjM1NDMyMQ@@._V1._SX97_SY140_.jpg,1964,soft_skin,7.4,11,10,1,90,0,2,1,1,50,3.9,573,85,http://content7.flixster.com/movie/49/03/68/4903685_det.jpg,5
1330,April Fool's Day,1018817,April Fool's Day,"http://ia.media-imdb.com/images/M/MV5BMTk5NjczNzU5MV5BMl5BanBnXkFtZTcwMjk4MTE2MQ@@._V1._SY314_CR15,0,214,314_.jpg",2008,1194078-april_fools_day,0,3,0,3,0,0,0,0,0,0,0,0,0,http://content8.flixster.com/movie/10/92/20/10922090_det.jpg,0
6725,Sgt. Pepper's Lonely Hearts Club Band,78239,Sargento Pepper,"http://ia.media-imdb.com/images/M/MV5BMTM2OTY2NTI1MV5BMl5BanBnXkFtZTcwNTQxOTYyMQ@@._V1._SX214_CR0,0,214,314_.jpg",1978,sgt-peppers-lonely-hearts-club-band,2.9,20,3,17,15,0,3,0,3,0,2.9,1491,52,http://content9.flixster.com/movie/25/58/255815_det.jpg,-37
784,The Cable Guy,115798,Un loco a domicilio,"http://ia.media-imdb.com/images/M/MV5BMTIwODI4OTA5NF5BMl5BanBnXkFtZTcwMzQ5MDYyMQ@@._V1._SX214_CR0,0,214,314_.jpg",1996,cable_guy,5.4,54,28,26,51,4,14,2,12,14,2.8,27061,50,http://content9.flixster.com/movie/10/87/05/10870531_det.jpg,1
6950,The Missing,338188,Desapariciones,"http://ia.media-imdb.com/images/M/MV5BMTA2NjgxMjczMTNeQTJeQWpwZ15BbWU3MDAxNTE2MjE@._V1._SX214_CR0,0,214,314_.jpg",2003,1127407-missing,6.1,168,98,70,58,6.1,39,21,18,53,3,6895,52,http://content8.flixster.com/movie/11/12/76/11127650_det.jpg,6
7120,Dark Wolf,326820,Dark Wolf,"http://ia.media-imdb.com/images/M/MV5BMjE1MzcxMzU5NF5BMl5BanBnXkFtZTcwNjUxNDA0MQ@@._V1._SY314_CR3,0,214,314_.jpg",2003,dark-wolf,0,0,0,0,0,0,0,0,0,0,0,0,0,http://images.rottentomatoescdn.com/images/defaults/poster_default.gif,0
5665,Knockaround Guys,211465,Ajuste de cuentas,"http://ia.media-imdb.com/images/M/MV5BMTU1MjMzMTcyOV5BMl5BanBnXkFtZTYwNzc0NDg5._V1._SX214_CR0,0,214,314_.jpg",2001,knockaround_guys,4.3,97,19,78,19,4.2,25,4,21,16,3.1,4913,58,http://content7.flixster.com/movie/27/43/274325_det.jpg,-39
6637,Thrashin',92085,Thrashin',"http://ia.media-imdb.com/images/M/MV5BMTg2NTU3ODMyNl5BMl5BanBnXkFtZTcwODkyNTYxMQ@@._V1._SY314_CR2,0,214,314_.jpg",1986,thrashin,0,0,0,0,0,0,0,0,0,0,0,0,0,http://content7.flixster.com/movie/26/01/260117_det.jpg,0
59044,Diminished Capacity,1007950,Diminished Capacity,"http://ia.media-imdb.com/images/M/MV5BNTAyODk4Mjk3MV5BMl5BanBnXkFtZTcwODY0MDY3MQ@@._V1._SY314_CR0,0,214,314_.jpg",2008,diminished_capacity,5.3,30,10,20,33,4.9,11,3,8,27,2.6,4729,37,http://content6.flixster.com/movie/10/84/96/10849656_det.jpg,-4
518,The Road to Wellville,111001,El balneario de Battle Creek,"http://ia.media-imdb.com/images/M/MV5BMTg0MDc4NTY5N15BMl5BanBnXkFtZTcwMzU1NTYyMQ@@._V1._SY314_CR4,0,214,314_.jpg",1994,road_to_wellville,4.9,16,7,9,43,0,2,1,1,50,2.8,1442,39,http://content8.flixster.com/movie/27/26/272698_det.jpg,4
6272,Eye of God,116261,Eye of God,"http://ia.media-imdb.com/images/M/MV5BMTc1NTE0MjQ1N15BMl5BanBnXkFtZTcwMTU3NjYxMQ@@._V1._SY314_CR4,0,214,314_.jpg",1997,eye_of_god,6.8,12,10,2,83,0,2,2,0,100,3.9,140,82,http://content9.flixster.com/movie/94/71/80/9471803_det.jpg,1
1809,Hana-bi,119250,Hana-bi. Flores de fuego,"http://ia.media-imdb.com/images/M/MV5BNTA3NzUwODE2MF5BMl5BanBnXkFtZTcwMDQ5MjMyMQ@@._V1._SY314_CR4,0,214,314_.jpg",1997,1091981-fireworks,8.2,18,17,1,94,0,2,2,0,100,4.3,3702,91,http://content8.flixster.com/movie/29/83/298330_det.jpg,3
55178,Stephanie Daley,483812,Stephanie Daley,"http://ia.media-imdb.com/images/M/MV5BMjAzODI4OTU5N15BMl5BanBnXkFtZTcwMDE1OTY0MQ@@._V1._SY314_CR8,0,214,314_.jpg",2006,stephanie_daley,7.3,49,44,5,89,7.8,17,16,1,94,2.9,2917,51,http://content7.flixster.com/movie/64/94/43/6494433_det.jpg,38
1611,My Own Private Idaho,102494,Mi Idaho privado,"http://ia.media-imdb.com/images/M/MV5BNTgyODU3MjE1M15BMl5BanBnXkFtZTcwNzQzOTcyMQ@@._V1._SY314_CR10,0,214,314_.jpg",1991,my_own_private_idaho,7,32,27,5,84,8.7,6,6,0,100,3.6,8810,79,http://content9.flixster.com/movie/10/93/52/10935275_det.jpg,5
1030,Pete's Dragon,76538,Pedro y el dragón Elliot,"http://ia.media-imdb.com/images/M/MV5BOTQ3ODEyNTk2M15BMl5BanBnXkFtZTcwMjY2MzQyMQ@@._V1._SY314_CR4,0,214,314_.jpg",1977,petes_dragon,4.6,20,10,10,50,0,2,2,0,100,3.1,7622,59,http://content6.flixster.com/movie/25/09/250924_det.jpg,-9
33437,Danny the Dog,342258,Danny the Dog,"http://ia.media-imdb.com/images/M/MV5BMTgwNjIyNTczMF5BMl5BanBnXkFtZTcwODI5MDkyMQ@@._V1._SX214_CR0,0,214,314_.jpg",2005,1145385-unleashed,6.2,128,83,45,64,5.9,31,15,16,48,3.5,17781,77,http://content9.flixster.com/movie/24/97/249719_det.jpg,-13
8908,Ladder 49,349710,Brigada 49,"http://ia.media-imdb.com/images/M/MV5BMTMyMjM0NjkyM15BMl5BanBnXkFtZTcwMTA4MDgyMQ@@._V1._SY314_CR5,0,214,314_.jpg",2004,the-art-of-russell-oberlin2004,0,0,0,0,0,0,0,0,0,0,0,0,0,http://content8.flixster.com/movie/10/94/73/10947338_det.jpg,0
348,Bullets Over Broadway,109348,Balas sobre Broadway,"http://ia.media-imdb.com/images/M/MV5BMTgyMDI1NzQwM15BMl5BanBnXkFtZTcwODE2OTMyMQ@@._V1._SY314_CR0,0,214,314_.jpg",1994,bullets_over_broadway,7.9,54,52,2,96,8.2,12,12,0,100,3.6,3913,79,http://content8.flixster.com/movie/26/94/269498_det.jpg,17
3917,Hellraiser,93177,"Hellraiser, los que traen el infierno","http://ia.media-imdb.com/images/M/MV5BMTc4OTQxMjM1MV5BMl5BanBnXkFtZTYwOTAzOTA5._V1._SY314_CR5,0,214,314_.jpg",1987,hellraiser,5.9,30,19,11,63,0,3,0,3,0,3.4,13712,77,http://content6.flixster.com/movie/28/39/283900_det.jpg,-14
6277,Winter Kills,80139,Muertes de invierno,"http://ia.media-imdb.com/images/M/MV5BMTk1NzA0NDA2Nl5BMl5BanBnXkFtZTcwMjQ1OTYyMQ@@._V1._SX214_CR0,0,214,314_.jpg",1979,winter-kills,7,14,12,2,85,0,3,2,1,66,3.3,254,49,http://content7.flixster.com/movie/10/85/91/10859165_det.jpg,36
58706,La misma luna,796307,La misma luna,"http://ia.media-imdb.com/images/M/MV5BNjY0NjgwMzk0MF5BMl5BanBnXkFtZTcwNTc4NzI2MQ@@._V1._SX214_CR0,0,214,314_.jpg",2007,same_moon,6.5,91,66,25,72,6.6,26,20,6,76,3.8,11693,80,http://content7.flixster.com/movie/10/92/39/10923945_det.jpg,-8
2667,The Mole People,49516,The Mole People,"http://ia.media-imdb.com/images/M/MV5BMTM5NjQ3NjI5N15BMl5BanBnXkFtZTcwOTQ3NjAzMQ@@._V1._SX214_CR0,0,214,314_.jpg",1956,mole_people,0,4,1,3,25,0,0,0,0,0,0,0,0,http://content9.flixster.com/movie/84/00/67/8400679_det.jpg,25
2410,Rocky III,84602,Rocky III,"http://ia.media-imdb.com/images/M/MV5BMjk5ODc4MjExMF5BMl5BanBnXkFtZTYwNDk1NDg5._V1._SY314_CR1,0,214,314_.jpg",1982,rocky_iii,5.4,29,18,11,62,0,2,1,1,50,3.3,48532,74,http://content7.flixster.com/movie/26/42/264213_det.jpg,-12
1409,Michael Clayton,465538,Michael Clayton,"http://ia.media-imdb.com/images/M/MV5BMTc0NTU5MjI2MV5BMl5BanBnXkFtZTcwMTg5NTQzMw@@._V1._SX214_CR0,0,214,314_.jpg",2007,michael_clayton,7.6,192,173,19,90,7.9,37,35,2,94,3.6,123924,72,http://content8.flixster.com/movie/99/32/72/9932722_det.jpg,18
3857,Bless the Child,163983,La bendición,"http://ia.media-imdb.com/images/M/MV5BMjA2NDIxNzkzNl5BMl5BanBnXkFtZTcwMjEwMDMyMQ@@._V1._SX214_CR0,0,214,314_.jpg",2000,bless_the_child,2.9,97,3,94,3,2.4,28,0,28,0,2.8,4085,45,http://content7.flixster.com/movie/27/47/274709_det.jpg,-42
5779,Piranha Part Two: The Spawning,82910,Piraña II: los vampiros del mar,"http://ia.media-imdb.com/images/M/MV5BMTc0MDE5NTAyNF5BMl5BanBnXkFtZTcwNTQ1MjkxMQ@@._V1._SY314_CR1,0,214,314_.jpg",1981,piranha_2_the_spawning,3.4,13,1,12,7,0,1,0,1,0,2,692,11,http://content7.flixster.com/movie/11/14/64/11146497_det.jpg,-4
33134,The Year of the Yao,360216,The Year of the Yao,"http://ia.media-imdb.com/images/M/MV5BMjE4ODg1NTk3MF5BMl5BanBnXkFtZTcwMjQ2ODgyMQ@@._V1._SX214_CR0,0,214,314_.jpg",2004,year_of_the_yao,6.2,32,21,11,65,6.1,11,7,4,63,3.6,562,67,http://content8.flixster.com/movie/10/88/66/10886674_det.jpg,-2
32058,Class Action,101590,Acción judicial,"http://ia.media-imdb.com/images/M/MV5BMTU3MTQ1NjM3NV5BMl5BanBnXkFtZTcwNDQ3NTcyMQ@@._V1._SY314_CR2,0,214,314_.jpg",1991,1034008-class_action,6.1,23,17,6,73,0,4,4,0,100,3,742,45,http://content7.flixster.com/movie/27/31/273101_det.jpg,28
2570,A Walk on the Moon,120613,A Walk on the Moon,"http://ia.media-imdb.com/images/M/MV5BMTU0MzI4NTQzN15BMl5BanBnXkFtZTcwNTMzNDgxMQ@@._V1._SY314_CR4,0,214,314_.jpg",1999,walk_on_the_moon,6.7,35,25,10,71,6.6,6,4,2,66,3.4,2848,67,http://content8.flixster.com/movie/26/82/268206_det.jpg,4
340,War,499556,El asesino,"http://ia.media-imdb.com/images/M/MV5BMTUyMzM3OTUxOV5BMl5BanBnXkFtZTcwMDI1MTU1MQ@@._V1._SY314_CR5,0,214,314_.jpg",2007,the-secret-war,0,0,0,0,0,0,0,0,0,0,0,0,0,http://content7.flixster.com/movie/10/84/31/10843105_det.jpg,0
2077,The Journey of Natty Gann,89385,Natty Gann,"http://ia.media-imdb.com/images/M/MV5BMTIzMTY2NDYwOF5BMl5BanBnXkFtZTcwOTk4NTUyMQ@@._V1._SY314_CR5,0,214,314_.jpg",1985,journey_of_natty_gann,6.7,13,12,1,92,0,3,3,0,100,3.5,1251,73,http://content8.flixster.com/movie/25/90/259006_det.jpg,19
8424,The Gay Divorcee,25164,La alegre divorciada,"http://ia.media-imdb.com/images/M/MV5BMTQzNTQ3ODk5OF5BMl5BanBnXkFtZTcwMTY0MzkzMQ@@._V1._SY314_CR21,0,214,314_.jpg",1934,gay_divorcee,7.8,8,8,0,100,0,0,0,0,0,0,0,0,http://content8.flixster.com/movie/37/40/82/3740826_det.jpg,100
6267,Assassination Tango,283897,Assassination Tango,"http://ia.media-imdb.com/images/M/MV5BMTQ3NjU5OTkzMF5BMl5BanBnXkFtZTcwMTY1NTQyMQ@@._V1._SX214_CR0,0,214,314_.jpg",2002,assassination_tango,5.6,87,42,45,48,6,29,14,15,48,2.9,572,37,http://content9.flixster.com/movie/27/22/272291_det.jpg,11
7897,The Ballad of Cable Hogue,65446,La balada de Cable Hogue,"http://ia.media-imdb.com/images/M/MV5BOTkwNTgwOTgyNV5BMl5BanBnXkFtZTcwNTA0OTEzMQ@@._V1._SY314_CR16,0,214,314_.jpg",1970,ballad_of_cable_hogue,7,13,12,1,92,0,3,3,0,100,3.6,929,75,http://content8.flixster.com/movie/10/86/73/10867306_det.jpg,17
3940,Slumber Party Massacre III,100639,Slumber Party Massacre III,"http://ia.media-imdb.com/images/M/MV5BMTQzNzA2Njk1MF5BMl5BanBnXkFtZTcwNzM2MzUxMQ@@._V1._SY314_CR3,0,214,314_.jpg",1990,slumber_party_massacre_3,0,2,0,2,0,0,0,0,0,0,0,0,0,http://content9.flixster.com/movie/28/96/84/2896843_det.jpg,0
1933,The Life of Emile Zola,29146,La vida de Emile Zola,"http://ia.media-imdb.com/images/M/MV5BMjEwNjM0MzY0MF5BMl5BanBnXkFtZTYwNTEwOTA5._V1._SX214_CR0,0,214,314_.jpg",1937,life_of_emile_zola,7,20,14,6,70,7.2,5,4,1,80,3.6,620,72,http://content7.flixster.com/movie/10/84/90/10849013_det.jpg,-2
5127,Dragonfly,259288,Dragonfly,"http://ia.media-imdb.com/images/M/MV5BMTQ0OTIxODg3NV5BMl5BanBnXkFtZTcwMzAwMDcxMQ@@._V1._SY314_CR2,0,214,314_.jpg",2002,dragonfly,3.6,121,8,113,6,3.5,30,1,29,3,3.1,9426,65,http://content7.flixster.com/movie/25/83/258321_det.jpg,-59
7358,Searching for Debra Winger,318049,Buscando a Debra Winger,"http://ia.media-imdb.com/images/M/MV5BMTM5MjQxODU3OF5BMl5BanBnXkFtZTcwNDk4MDUyMQ@@._V1._SY314_CR4,0,214,314_.jpg",2002,searching_for_debra_winger,0,4,3,1,75,0,1,1,0,100,3.2,487,50,http://content9.flixster.com/movie/27/96/279611_det.jpg,25
3781,Shaft in Africa,70679,Shaft en África,"http://ia.media-imdb.com/images/M/MV5BMjA4ODAxOTcxN15BMl5BanBnXkFtZTcwNzY2MjIyMQ@@._V1._SY314_CR10,0,214,314_.jpg",1973,shaft_in_africa,4.9,7,3,4,42,0,0,0,0,0,0,0,0,http://content9.flixster.com/movie/10/87/58/10875831_det.jpg,42
50274,Venus,489327,Venus,"http://ia.media-imdb.com/images/M/MV5BMTQ1ODQ4MDg0OV5BMl5BanBnXkFtZTcwOTk5NDQ0MQ@@._V1._SX214_CR0,0,214,314_.jpg",2006,venus,7.3,145,129,16,88,8,35,35,0,100,3.6,3984,73,http://content8.flixster.com/movie/33/33/29/3333294_det.jpg,15
3262,Twin Peaks: Fire Walk with Me,105665,Twin Peaks (El diario de Laura Palmer),"http://ia.media-imdb.com/images/M/MV5BNDYxMzUzNjk4OV5BMl5BanBnXkFtZTcwMTUxNTEzMQ@@._V1._SY314_CR5,0,214,314_.jpg",1992,twin-peaks-fire-walk-with-me,6.2,50,31,19,62,4.4,5,2,3,40,3.6,10347,79,http://content9.flixster.com/movie/10/87/63/10876351_det.jpg,-17
27186,Kirikou et la sorcière,181627,Kirikú y la bruja,"http://ia.media-imdb.com/images/M/MV5BMTQ0NDk4NjI5OF5BMl5BanBnXkFtZTcwNTg1NzgyMQ@@._V1._SY314_CR1,0,214,314_.jpg",1998,kirikou_and_the_sorceress,7.4,24,23,1,95,7.8,8,8,0,100,3.9,1078,85,http://content8.flixster.com/movie/29/39/293926_det.jpg,10
1292,Being There,78841,"Bienvenido, Mr. Chance","http://ia.media-imdb.com/images/M/MV5BMTYyMTYzNTU2OV5BMl5BanBnXkFtZTcwMDQ4MTAyMQ@@._V1._SY314_CR0,0,214,314_.jpg",1979,being_there,8.4,38,36,2,94,0,4,4,0,100,4.1,6371,91,http://content6.flixster.com/movie/25/44/254496_det.jpg,3
1921,Pi,138704,"Pi, fe en el caos","http://ia.media-imdb.com/images/M/MV5BMTI4ODUzNzY3MF5BMl5BanBnXkFtZTYwOTU2OTY4._V1._SY298_CR1,0,214,298_.jpg",1998,pi,7.2,49,42,7,85,6.7,11,8,3,72,3.8,33850,86,http://content7.flixster.com/movie/26/78/267897_det.jpg,-1
4963,Ocean's Eleven,240772,Ocean's eleven. Hagan juego,"http://ia.media-imdb.com/images/M/MV5BMTgwMTQ5NzEzN15BMl5BanBnXkFtZTYwNjU5NjA5._V1._SX214_CR0,0,214,314_.jpg",2001,oceans_eleven,6.9,166,135,31,81,7.2,33,28,5,84,3.6,185259,76,http://content6.flixster.com/movie/11/15/10/11151032_det.jpg,5
6890,Elephant,363589,Elephant,"http://ia.media-imdb.com/images/M/MV5BMTg0MTQ0NjAwN15BMl5BanBnXkFtZTcwNDExMTYyMQ@@._V1._SY288_CR1,0,214,288_.jpg",2003,elephant,7,142,100,42,70,7.1,35,27,8,77,3.6,15005,79,http://content7.flixster.com/movie/72/69/79/7269797_det.jpg,-9
60674,Stargate: Continuum,929629,Stargate: Continuum,"http://ia.media-imdb.com/images/M/MV5BMTUyOTcyNzg3OF5BMl5BanBnXkFtZTcwODc2MDY3MQ@@._V1._SY314_CR11,0,214,314_.jpg",2008,stargate_continuum,0,1,1,0,100,0,0,0,0,0,0,0,0,http://content7.flixster.com/movie/10/84/43/10844301_det.jpg,100
8734,Love Happy,41604,Amor en conserva,"http://ia.media-imdb.com/images/M/MV5BMTUwMjM4MzY4MF5BMl5BanBnXkFtZTcwMDA4NzA0MQ@@._V1._SY314_CR5,0,214,314_.jpg",1949,love_happy,0,2,2,0,100,0,0,0,0,0,0,0,0,http://content6.flixster.com/movie/29/95/299516_det.jpg,100
26791,Shining Through,105391,Resplandor en la oscuridad,"http://ia.media-imdb.com/images/M/MV5BMTg3MDAwMjU3NV5BMl5BanBnXkFtZTcwNjI0MzcyMQ@@._V1._SY314_CR3,0,214,314_.jpg",1992,shining_through,4.4,13,4,9,30,0,2,1,1,50,3.4,1160,71,http://content7.flixster.com/movie/10/89/05/10890545_det.jpg,-41
8003,Bedlam,38343,Bedlam,"http://ia.media-imdb.com/images/M/MV5BMTU2NTQ5OTQ5MF5BMl5BanBnXkFtZTcwMDI2NDAzMQ@@._V1._SY314_CR24,0,214,314_.jpg",1946,bedlam,6.5,15,13,2,86,0,2,2,0,100,3.3,649,56,http://content7.flixster.com/movie/95/34/44/9534445_det.jpg,30
6118,Przypadek,84549,El azar,"http://ia.media-imdb.com/images/M/MV5BMTg0OTEzNTI4Nl5BMl5BanBnXkFtZTcwNjI2NTYyMQ@@._V1._SY314_CR4,0,214,314_.jpg",1981,blind-chance,7.6,6,5,1,83,0,0,0,0,0,0,0,0,http://content9.flixster.com/movie/93/54/82/9354823_det.jpg,83
3911,Best in Show,218839,Very Important Perros,"http://ia.media-imdb.com/images/M/MV5BMTU1NTcxMTIxNF5BMl5BanBnXkFtZTcwMDQyODEyMQ@@._V1._SY314_CR8,0,214,314_.jpg",2000,best_in_show,7.5,107,101,6,94,7.6,29,28,1,96,3.7,12719,87,http://content7.flixster.com/movie/10/87/12/10871241_det.jpg,7
2952,Sydney,119256,Sidney,"http://ia.media-imdb.com/images/M/MV5BODYwMjU0OTYyMF5BMl5BanBnXkFtZTcwMDg5MDgxMQ@@._V1._SY314_CR1,0,214,314_.jpg",1996,hard_eight,6.9,32,26,6,81,7.1,11,9,2,81,3.7,3180,81,http://content8.flixster.com/movie/27/33/273322_det.jpg,0
1943,The Greatest Show on Earth,44672,El mayor espectáculo del mundo,"http://ia.media-imdb.com/images/M/MV5BMTQ3OTUwNzQyOV5BMl5BanBnXkFtZTcwODA0MDUyMQ@@._V1._SY314_CR5,0,214,314_.jpg",1952,under-the-carp-banner2006,0,0,0,0,0,0,0,0,0,0,0,0,0,http://content6.flixster.com/movie/10/88/18/10881888_det.jpg,0
2581,Never Been Kissed,151738,Nunca me han besado,"http://ia.media-imdb.com/images/M/MV5BMTQyODI1Njg3Ml5BMl5BanBnXkFtZTcwNTI0MDcyMQ@@._V1._SY314_CR3,0,214,314_.jpg",1999,never_been_kissed,5.7,79,44,35,55,5.4,25,12,13,48,3.3,53088,70,http://content8.flixster.com/movie/26/46/264622_det.jpg,-15
7336,La caduta degli dei,64118,La caída de los dioses,"http://ia.media-imdb.com/images/M/MV5BMTU4MzM2MDg4N15BMl5BanBnXkFtZTYwNjI1MDI5._V1._SX214_CR0,0,214,314_.jpg",1969,1005155-damned,8.1,10,9,1,90,0,1,1,0,100,4,255,82,http://content8.flixster.com/movie/10/89/58/10895846_det.jpg,8
62553,The Secret Life of Bees,416212,La vida secreta de las abejas,"http://ia.media-imdb.com/images/M/MV5BMTQ1NzM4MzkzNl5BMl5BanBnXkFtZTcwMDM0MjgyMg@@._V1._SY314_CR18,0,214,314_.jpg",2008,secret_life_of_bees,5.9,131,75,56,57,6.2,27,17,10,62,3.7,35593,79,http://content7.flixster.com/movie/10/89/03/10890353_det.jpg,-22
5564,Swimfan,283026,Fanática (Swimfan),"http://ia.media-imdb.com/images/M/MV5BMTIzOTkzNTM0Ml5BMl5BanBnXkFtZTcwODQzNzAwMQ@@._V1._SX214_CR0,0,214,314_.jpg",2002,swimfan,3.9,89,13,76,14,4.3,16,4,12,25,2.5,5068,38,http://content6.flixster.com/movie/10/88/37/10883720_det.jpg,-24
7310,Raw Deal,91828,Ejecutor,"http://ia.media-imdb.com/images/M/MV5BNjYwNjY4MTQzN15BMl5BanBnXkFtZTcwOTM4OTQyMQ@@._V1._SY314_CR3,0,214,314_.jpg",1986,1017226-raw_deal,3.8,12,3,9,25,0,1,0,1,0,2.7,3041,32,http://content7.flixster.com/movie/10/87/80/10878017_det.jpg,-7
3413,Deep Impact,120647,Deep Impact,"http://ia.media-imdb.com/images/M/MV5BMTQ0OTg5ODM0N15BMl5BanBnXkFtZTYwNTE2MzM5._V1._SX214_CR0,0,214,314_.jpg",1998,deep_impact,5.7,51,24,27,47,5.9,6,2,4,33,2.9,28624,51,http://content8.flixster.com/movie/10/88/98/10889858_det.jpg,-4
42053,Dirty Love,327643,Dirty Love,"http://ia.media-imdb.com/images/M/MV5BMTgzMTQ2NjQyMF5BMl5BanBnXkFtZTcwMzg4OTEzMQ@@._V1._SX214_CR0,0,214,314_.jpg",2005,dirty_love,2.2,28,1,27,3,1.6,10,0,10,0,3.4,3700,67,http://content9.flixster.com/movie/10/92/39/10923995_det.jpg,-64
2302,My Cousin Vinny,104952,Mi primo Vinny,"http://ia.media-imdb.com/images/M/MV5BMTkyNjc3NDIwN15BMl5BanBnXkFtZTYwNTQ4MjE5._V1._SY314_CR3,0,214,314_.jpg",1992,my_cousin_vinny,6.9,38,33,5,86,7,8,6,2,75,0,0,0,http://content6.flixster.com/movie/26/78/267816_det.jpg,86
5088,Les valseuses,72353,Los rompepelotas,"http://ia.media-imdb.com/images/M/MV5BMjAzOTc1MzQ5NF5BMl5BanBnXkFtZTcwNTI1NzkxMQ@@._V1._SY314_CR1,0,214,314_.jpg",1974,going_places,6.9,6,5,1,83,0,0,0,0,0,0,0,0,http://content7.flixster.com/movie/10/92/32/10923289_det.jpg,83
34645,Race with the Devil,73600,Carrera con el diablo,"http://ia.media-imdb.com/images/M/MV5BMTM0MzU4MDcwM15BMl5BanBnXkFtZTcwNjY1MTkyMQ@@._V1._SY314_CR4,0,214,314_.jpg",1975,race_with_the_devil,5,5,2,3,40,0,0,0,0,0,0,0,0,http://content7.flixster.com/movie/25/69/256993_det.jpg,40
42007,Rumor Has It...,398375,Dicen por ahí...,"http://ia.media-imdb.com/images/M/MV5BOTg3Njk2NTIxNF5BMl5BanBnXkFtZTcwNTc4MTEzMw@@._V1._SX214_CR0,0,214,314_.jpg",2005,rumor_has_it,4.4,110,22,88,20,4.2,30,4,26,13,3,41917,51,http://content9.flixster.com/movie/31/18/311803_det.jpg,-31
58376,Zeitgeist,1166827,Zeitgeist,"http://ia.media-imdb.com/images/M/MV5BMjEzMDIzNzM2MF5BMl5BanBnXkFtZTcwNDM5OTk1MQ@@._V1._SY314_CR4,0,214,314_.jpg",2007,zeitgeist,0,0,0,0,0,0,0,0,0,0,0,0,0,http://content7.flixster.com/movie/10/92/94/10929461_det.jpg,0
51575,Wild Hogs,486946,Cerdos salvajes,"http://ia.media-imdb.com/images/M/MV5BMTQ4MTE5MjY5OV5BMl5BanBnXkFtZTcwNDEwMzUzMw@@._V1._SX214_CR0,0,214,314_.jpg",2007,wild_hogs,3.8,139,20,119,14,3.4,34,3,31,8,3.4,86633,72,http://content6.flixster.com/movie/44/00/87/4400876_det.jpg,-58
1963,Take the Money and Run,65063,Toma el dinero y corre,"http://ia.media-imdb.com/images/M/MV5BMTI0MDg4ODgxNV5BMl5BanBnXkFtZTcwNzExODUyMQ@@._V1._SY314_CR8,0,214,314_.jpg",1969,take_the_money_and_run,6.9,13,12,1,92,0,1,0,1,0,0,0,0,http://content9.flixster.com/movie/28/30/283091_det.jpg,92
864,The Time Traveler's Wife,452694,The Time Traveler's Wife,"http://ia.media-imdb.com/images/M/MV5BMTU0MzkzNzg0Nl5BMl5BanBnXkFtZTcwNzUwNzQ2Mg@@._V1._SX214_CR0,0,214,314_.jpg",2009,time_travelers_wife,5.1,151,56,95,37,4.8,34,10,24,29,2.9,189828,65,http://content7.flixster.com/movie/10/92/43/10924397_det.jpg,-28
410,Addams Family Values,106220,La familia Addams: la tradición continúa,"http://ia.media-imdb.com/images/M/MV5BMTIwMTQ4MDA0MV5BMl5BanBnXkFtZTcwMDg3NTEyMQ@@._V1._SY314_CR3,0,214,314_.jpg",1993,addams_family_values,6.3,35,26,9,74,5.5,7,4,3,57,3.1,21548,57,http://content9.flixster.com/movie/26/62/266215_det.jpg,17
8014,Bom yeoreum gaeul gyeoul geurigo bom,374546,"Primavera, verano, otoño, invierno... y primavera","http://ia.media-imdb.com/images/M/MV5BMTI0ODMwOTIxOV5BMl5BanBnXkFtZTcwMzE2NDUyMQ@@._V1._SX214_CR0,0,214,314_.jpg",2003,spring-summer-fall-winter-and-spring,8.1,94,89,5,94,8.1,26,24,2,92,4.2,7663,92,http://content6.flixster.com/movie/26/79/267996_det.jpg,2
40491,Tulitikkutehtaan tyttö,98532,La chica de la fábrica de cerillas,"http://ia.media-imdb.com/images/M/MV5BMTk2MTQyNjQzMV5BMl5BanBnXkFtZTcwODkzNDMzMQ@@._V1._SY314_CR5,0,214,314_.jpg",1990,match_factory_girl,0,3,3,0,100,0,0,0,0,0,0,0,0,http://content8.flixster.com/movie/89/59/16/8959162_det.jpg,100
8605,Taxi 3,295721,Taxi 3,"http://ia.media-imdb.com/images/M/MV5BMTcyOTI3MDU2MV5BMl5BanBnXkFtZTcwMzI0MDUzMQ@@._V1._SY314_CR4,0,214,314_.jpg",2003,taxi_3,0,1,1,0,100,0,0,0,0,0,0,0,0,http://content9.flixster.com/movie/10/91/40/10914019_det.jpg,100
1863,Major League: Back to the Minors,120742,Major League: Back to the Minors,"http://ia.media-imdb.com/images/M/MV5BMTIwODgwNDk0M15BMl5BanBnXkFtZTcwMjYyMTcxMQ@@._V1._SX214_CR0,0,214,314_.jpg",1998,major_league_back_to_the_minors,3,19,4,15,21,0,4,1,3,25,2.6,1952,31,http://content6.flixster.com/movie/25/94/259400_det.jpg,-10
61073,Hell Ride,411475,Hell Ride,"http://ia.media-imdb.com/images/M/MV5BMTY0MTMwODkwN15BMl5BanBnXkFtZTcwMzE1OTc1MQ@@._V1._SX214_CR0,0,214,314_.jpg",2008,1192781-hell_ride,3.5,59,6,53,10,3.5,19,2,17,10,2.7,3570,33,http://content6.flixster.com/movie/10/83/85/10838528_det.jpg,-23
8740,Donzoko,50330,Los bajos fondos,"http://ia.media-imdb.com/images/M/MV5BMTU0MDM4MDI1Nl5BMl5BanBnXkFtZTcwMTY5MjAwMQ@@._V1._SY314_CR4,0,214,314_.jpg",1957,lower_depths,8.2,5,4,1,80,0,1,1,0,100,3.9,685,82,http://content6.flixster.com/movie/98/44/32/9844320_det.jpg,-2
26174,Shooting Dogs,420901,Shooting Dogs,"http://ia.media-imdb.com/images/M/MV5BMTM4NjA2MTAwNl5BMl5BanBnXkFtZTcwMzc0NzI0MQ@@._V1._SX214_CR0,0,214,314_.jpg",2005,beyond-the-gates,7.2,60,50,10,83,6.5,18,13,5,72,3.9,11089,81,http://content9.flixster.com/movie/10/87/23/10872351_det.jpg,2
1394,Raising Arizona,93822,Arizona baby,"http://ia.media-imdb.com/images/M/MV5BMTg0NjYzOTUzNF5BMl5BanBnXkFtZTcwODkyMDMyMQ@@._V1._SY314_CR3,0,214,314_.jpg",1987,raising_arizona,7.6,49,44,5,89,5.5,6,3,3,50,3.6,19379,82,http://content9.flixster.com/movie/99/56/74/9956747_det.jpg,7
424,Blue Chips,109305,Ganar de cualquier manera,"http://ia.media-imdb.com/images/M/MV5BMTMwMzI3MDk0MV5BMl5BanBnXkFtZTcwMzMxMzgyMQ@@._V1._SY314_CR4,0,214,314_.jpg",1994,blue_chips,5.1,26,10,16,38,4.6,8,3,5,37,3,1545,50,http://content8.flixster.com/movie/26/12/261294_det.jpg,-12
49286,The Holiday,457939,Vacaciones,"http://ia.media-imdb.com/images/M/MV5BMTQ2Njk0MDU1NV5BMl5BanBnXkFtZTcwODUxNDI0MQ@@._V1._SY314_CR2,0,214,314_.jpg",2006,holiday_2006,0,0,0,0,0,0,0,0,0,0,0,0,0,http://content9.flixster.com/movie/10/88/62/10886279_det.jpg,0
9004,D.A.R.Y.L.,88979,D.A.R.Y.L.,"http://ia.media-imdb.com/images/M/MV5BMTMzNjYwOTg1NV5BMl5BanBnXkFtZTcwMjkwMjcyMQ@@._V1._SY314_CR23,0,214,314_.jpg",1985,daryl,3.7,6,2,4,33,0,0,0,0,0,0,0,0,http://content7.flixster.com/movie/53/96/21/5396213_det.jpg,33
744,Brothers in Trouble,112586,Brothers in Trouble,http://ia.media-imdb.com/images/M/MV5BMjEzNDAxODk2Nl5BMl5BanBnXkFtZTcwOTAyNTYxMQ@@._V1._SX77_SY140_.jpg,1995,brothers_in_trouble,0,3,3,0,100,0,0,0,0,0,0,0,0,http://content6.flixster.com/movie/10/97/76/10977688_det.jpg,100
3222,U-Carmen e-Khayelitsha,445776,U-Carmen e-Khayelitsha,"http://ia.media-imdb.com/images/M/MV5BMzM4MTQ1NTg5N15BMl5BanBnXkFtZTcwOTM3NTk0MQ@@._V1._SY314_CR2,0,214,314_.jpg",2005,ucarmen-ekhayelitsha,7.4,20,19,1,95,7.8,7,7,0,100,3.2,1204,50,http://content7.flixster.com/movie/33/19/82/3319829_det.jpg,45
6605,The Man in the Glass Booth,73345,The Man in the Glass Booth,"http://ia.media-imdb.com/images/M/MV5BMTI2ODMzMjA2MV5BMl5BanBnXkFtZTcwODU1NTYyMQ@@._V1._SY314_CR4,0,214,314_.jpg",1975,man_in_the_glass_booth,0,3,3,0,100,0,1,1,0,100,4,91,88,http://content6.flixster.com/movie/99/59/22/9959228_det.jpg,12
5766,"I, Madman",97557,Lecturas diabólicas,"http://ia.media-imdb.com/images/M/MV5BMTU0NjU2OTEyMl5BMl5BanBnXkFtZTcwNDc2NDcyMQ@@._V1._SY314_CR4,0,214,314_.jpg",1989,i_madman,0,4,3,1,75,0,1,1,0,100,3,387,44,http://content6.flixster.com/movie/28/13/281300_det.jpg,31
214,Before the Rain,110882,Antes de la lluvia,"http://ia.media-imdb.com/images/M/MV5BMTM3MzAwMzc1N15BMl5BanBnXkFtZTcwMjA4NjA3MQ@@._V1._SY314_CR6,0,214,314_.jpg",1994,before_the_rain,7.5,12,10,2,83,0,2,2,0,100,4.4,1683,93,http://content6.flixster.com/movie/10/89/78/10897876_det.jpg,-10
568,Bhaji on the Beach,106408,Bhaji on the Beach,"http://ia.media-imdb.com/images/M/MV5BMTYyNTM0Mzk3MF5BMl5BanBnXkFtZTcwNDAzMTgxMQ@@._V1._SY314_CR4,0,214,314_.jpg",1993,bhaji_on_the_beach,7.4,8,7,1,87,0,2,2,0,100,3.3,372,60,http://content7.flixster.com/movie/10/90/24/10902481_det.jpg,27
8737,Crimetime,115976,La hora del crimen,"http://ia.media-imdb.com/images/M/MV5BMTUxODIzODAzMl5BMl5BanBnXkFtZTcwNjkzNDUxMQ@@._V1._SX214_CR0,0,214,314_.jpg",1996,crimetime,0,1,0,1,0,0,0,0,0,0,0,0,0,http://content8.flixster.com/movie/10/86/25/10862550_det.jpg,0
5963,The Children's Hour,54743,La calumnia,"http://ia.media-imdb.com/images/M/MV5BMjEzMjc3MDA1Ml5BMl5BanBnXkFtZTcwOTI3MDYyMQ@@._V1._SY314_CR3,0,214,314_.jpg",1961,childrens_hour,7.2,5,5,0,100,0,0,0,0,0,0,0,0,http://content7.flixster.com/movie/29/33/293325_det.jpg,100
25798,De fortabte sjæles ø,466449,La isla de las almas perdidas,"http://ia.media-imdb.com/images/M/MV5BMTI0NjMxOTgyMV5BMl5BanBnXkFtZTcwNDg0NjE0MQ@@._V1._SY314_CR9,0,214,314_.jpg",2007,island-of-lost-souls,0,0,0,0,0,0,0,0,0,0,0,0,0,http://content8.flixster.com/movie/10/85/54/10855490_det.jpg,0
608,Fargo,116282,Fargo,"http://ia.media-imdb.com/images/M/MV5BMTM3NTQwMDc2N15BMl5BanBnXkFtZTcwNTEyNjU5Mw@@._V1._SX214_CR0,0,214,314_.jpg",1996,fargo,8.4,66,62,4,93,7.6,21,18,3,85,3.9,48610,91,http://content6.flixster.com/movie/31/32/313212_det.jpg,2
59382,Le voyage du ballon rouge,826711,Le voyage du ballon rouge,"http://ia.media-imdb.com/images/M/MV5BMTUzODUwNTI1Nl5BMl5BanBnXkFtZTcwNzM5NDI2MQ@@._V1._SX214_CR0,0,214,314_.jpg",2007,flight_of_the_red_balloon,6.9,82,65,17,79,7.3,22,19,3,86,3.4,1609,59,http://content6.flixster.com/movie/10/92/48/10924828_det.jpg,20
5126,The Deadly Mantis,50294,The Deadly Mantis,"http://ia.media-imdb.com/images/M/MV5BMTcwODgzOTE0OV5BMl5BanBnXkFtZTcwNDY5MTEyMQ@@._V1._SX214_CR0,0,214,314_.jpg",1957,deadly_mantis,4.2,8,2,6,25,0,0,0,0,0,0,0,0,http://content7.flixster.com/movie/11/15/17/11151769_det.jpg,25
26226,"Hi, Mom!",65836,"Hola, mamá","http://ia.media-imdb.com/images/M/MV5BMTQ2OTU5MDQ2OF5BMl5BanBnXkFtZTcwNjM1MTQyMQ@@._V1._SX214_CR0,0,214,314_.jpg",1970,hi_mom,7.2,8,5,3,62,0,0,0,0,0,0,0,0,http://content9.flixster.com/movie/10/43/99/10439959_det.jpg,62
5279,Impromptu,102103,Pasiones privadas de una mujer,"http://ia.media-imdb.com/images/M/MV5BMjAzMDk1OTA1Ml5BMl5BanBnXkFtZTcwMzYwMDcxMQ@@._V1._SX214_CR0,0,214,314_.jpg",1991,impromptu,6.2,15,12,3,80,5.7,6,4,2,66,3.6,1242,73,http://content7.flixster.com/movie/10/84/99/10849957_det.jpg,7
3694,The Toxic Avenger Part II,98503,The Toxic Avenger Part II,"http://ia.media-imdb.com/images/M/MV5BMTIyMTMwNzA5NV5BMl5BanBnXkFtZTcwMjcyMDUyMQ@@._V1._SY314_CR4,0,214,314_.jpg",1989,the-toxic-avenger-part-ii,2.7,8,0,8,0,0,0,0,0,0,0,0,0,http://content8.flixster.com/movie/10/93/48/10934826_det.jpg,0
3819,Tampopo,92048,Tampopo,"http://ia.media-imdb.com/images/M/MV5BMTI2OTc1NDgzNl5BMl5BanBnXkFtZTcwMzg2MTIyMQ@@._V1._SY314_CR2,0,214,314_.jpg",1985,tampopo,8.3,13,13,0,100,0,1,1,0,100,4.3,2542,93,http://content9.flixster.com/movie/30/69/306915_det.jpg,7
48560,Running with Scissors,439289,Recortes de mi vida,"http://ia.media-imdb.com/images/M/MV5BMTMyMzk0NjY3NV5BMl5BanBnXkFtZTcwMjM3NTE0MQ@@._V1._SY314_CR2,0,214,314_.jpg",2006,running_with_scissors,5,129,39,90,30,5,38,12,26,31,3.1,39912,55,http://content6.flixster.com/movie/97/36/08/9736088_det.jpg,-25
145,Bad Boys,112442,Dos policías rebeldes (Bad Boys),"http://ia.media-imdb.com/images/M/MV5BMTI1NzAyNzA3OF5BMl5BanBnXkFtZTYwODU3OTk5._V1._SY314_CR2,0,214,314_.jpg",1995,1062483-bad_boys,4.8,41,16,25,39,3.7,9,1,8,11,3.5,67658,79,http://content8.flixster.com/movie/28/27/282798_det.jpg,-40
5703,Wholly Moses!,81751,Santísimo Moisés,"http://ia.media-imdb.com/images/M/MV5BMjAwNjIwNzE2Ml5BMl5BanBnXkFtZTcwNjcyODUyMQ@@._V1._SY314_CR0,0,214,314_.jpg",1980,wholly_moses,0,0,0,0,0,0,0,0,0,0,0,0,0,http://content8.flixster.com/movie/10/87/50/10875082_det.jpg,0
55280,Lars and the Real Girl,805564,Lars y una chica de verdad,"http://ia.media-imdb.com/images/M/MV5BMTgyMTg3ODU3M15BMl5BanBnXkFtZTcwMTMxODU2MQ@@._V1._SY314_CR7,0,214,314_.jpg",2007,1175569-lars_and_the_real_girl,7.1,132,107,25,81,7.1,35,28,7,80,3.8,44751,84,http://content8.flixster.com/movie/96/89/85/9689854_det.jpg,-3
52666,Benny's Video,103793,El vídeo de Benny,"http://ia.media-imdb.com/images/M/MV5BMTg3NzgwNTc1MF5BMl5BanBnXkFtZTcwMDMzNzIzMQ@@._V1._SY314_CR5,0,214,314_.jpg",1992,bennys_video,5.3,6,2,4,33,0,0,0,0,0,0,0,0,http://content9.flixster.com/movie/85/95/859535_det.jpg,33
7173,Along Came Polly,343135,Y entonces llegó ella,"http://ia.media-imdb.com/images/M/MV5BMTUyNDI5OTQ4NV5BMl5BanBnXkFtZTcwNDE4MDYyMQ@@._V1._SX214_CR0,0,214,314_.jpg",2004,along_came_polly,4.8,152,39,113,25,4.7,36,8,28,22,3.1,42224,54,http://content6.flixster.com/movie/10/89/41/10894152_det.jpg,-29
4,Waiting to Exhale,114885,Esperando un respiro,"http://ia.media-imdb.com/images/M/MV5BMTczMTMyMTgyM15BMl5BanBnXkFtZTcwOTc4OTQyMQ@@._V1._SY314_CR4,0,214,314_.jpg",1995,waiting_to_exhale,5.6,25,14,11,56,5.5,11,5,6,45,3.3,5666,79,http://content9.flixster.com/movie/10/94/17/10941715_det.jpg,-23
8487,Please Don't Eat the Daisies,54188,No os comáis las margaritas,"http://ia.media-imdb.com/images/M/MV5BMTQwMzc0NTc3OV5BMl5BanBnXkFtZTcwNTk5MzgyMQ@@._V1._SY314_CR24,0,214,314_.jpg",1960,please_dont_eat_the_daisies,5.5,6,4,2,66,0,0,0,0,0,0,0,0,http://content6.flixster.com/movie/11/13/15/11131592_det.jpg,66
1624,A Thousand Acres,120323,Heredarás la tierra,"http://ia.media-imdb.com/images/M/MV5BMTQ0NjA2OTAzMV5BMl5BanBnXkFtZTcwMTU1MjYxMQ@@._V1._SY314_CR5,0,214,314_.jpg",1997,thousand_acres,4.3,47,11,36,23,3.7,14,1,13,7,3,932,40,http://content9.flixster.com/movie/10/88/70/10887047_det.jpg,-17
41699,Ivan Groznyy: Skaz vmroy - Boyarskyy zagovor,51790,La conjura de los boyardos,"http://ia.media-imdb.com/images/M/MV5BMzg4NDkxNTU0OV5BMl5BanBnXkFtZTcwNTQ4OTcxMQ@@._V1._SY314_CR7,0,214,314_.jpg",1958,1112470-eisenstein,6.2,11,7,4,63,6.2,5,4,1,80,2.4,42,33,http://content8.flixster.com/movie/11/14/05/11140558_det.jpg,30
1095,Glengarry Glen Ross,104348,Glengarry Glen Ross: Éxito a cualquier precio,"http://ia.media-imdb.com/images/M/MV5BMjEwMzA1MTc1MV5BMl5BanBnXkFtZTYwOTg4MzA5._V1._SY314_CR4,0,214,314_.jpg",1992,glengarry_glen_ross,8.5,41,40,1,97,0,4,4,0,100,3.9,9083,87,http://content6.flixster.com/movie/10/93/46/10934652_det.jpg,10
2937,The Palm Beach Story,35169,Un marido rico,"http://ia.media-imdb.com/images/M/MV5BMTE5OTM5NTExNl5BMl5BanBnXkFtZTcwMjc1NDcyMQ@@._V1._SY314_CR3,0,214,314_.jpg",1942,palm_beach_story,8.6,21,21,0,100,0,3,3,0,100,3.9,975,83,http://content8.flixster.com/movie/10/88/25/10882522_det.jpg,17
8017,10 Rillington Place,66730,El estrangulador de Rillington Place,http://ia.media-imdb.com/images/M/MV5BODQwNTg4NjQzNF5BMl5BanBnXkFtZTcwMzgzNTUyMQ@@._V1._SX96_SY140_.jpg,1971,10_rillington_place,6.5,8,5,3,62,0,1,1,0,100,3.9,564,87,http://content8.flixster.com/movie/10/92/16/10921658_det.gif,-25
5344,Thief of Hearts,88256,Ladrón de pasiones,"http://ia.media-imdb.com/images/M/MV5BMTc0ODcwNzYzM15BMl5BanBnXkFtZTcwNTE2NzcxMQ@@._V1._SY314_CR2,0,214,314_.jpg",1984,thief_of_hearts,3.2,6,0,6,0,0,0,0,0,0,0,0,0,http://content6.flixster.com/movie/10/88/20/10882048_det.jpg,0
2844,The Minus Man,151582,The Minus Man,"http://ia.media-imdb.com/images/M/MV5BMjA4NDQzODMzM15BMl5BanBnXkFtZTcwNTAxOTEyMQ@@._V1._SX214_CR0,0,214,314_.jpg",1999,minus_man,5.9,34,20,14,58,6.7,8,6,2,75,3,1065,43,http://content7.flixster.com/movie/27/49/274997_det.jpg,15
48322,Jackass Number Two,493430,Jackass Number Two,"http://ia.media-imdb.com/images/M/MV5BMTY2MjE4MjA0OF5BMl5BanBnXkFtZTcwNDU2ODU0MQ@@._V1._SY314_CR5,0,214,314_.jpg",2006,jackass_number_2,5.8,103,65,38,63,5.6,24,14,10,58,3.6,75153,83,http://content8.flixster.com/movie/10/88/83/10888302_det.jpg,-20
5020,Silent Trigger,117653,Soldado,"http://ia.media-imdb.com/images/M/MV5BMTIzNTQxNzgzNF5BMl5BanBnXkFtZTcwNDkzNjAwMQ@@._V1._SY314_CR1,0,214,314_.jpg",1996,silent_trigger,0,4,1,3,25,0,0,0,0,0,0,0,0,http://content7.flixster.com/movie/27/94/279409_det.jpg,25
7035,Streets of Fire,88194,Calles de fuego,"http://ia.media-imdb.com/images/M/MV5BMTQ0MTM5ODE5N15BMl5BanBnXkFtZTcwMzY3MjYyMQ@@._V1._SY314_CR4,0,214,314_.jpg",1984,streets_of_fire,5.9,20,12,8,60,0,1,1,0,100,3.5,2031,70,http://content9.flixster.com/movie/10/74/54/10745447_det.jpg,-10
42632,Chinjeolhan geumjassi,451094,Chinjeolhan geumjassi,"http://ia.media-imdb.com/images/M/MV5BMTM3MzUxODIxMF5BMl5BanBnXkFtZTcwNDMyODczMQ@@._V1._SX214_CR0,0,214,314_.jpg",2005,1153496-lady_vengeance,7,84,62,22,73,7.3,22,18,4,81,4,23638,86,http://content7.flixster.com/movie/10/89/05/10890561_det.jpg,-13
31467,The Great White Hope,65797,La gran esperanza blanca,"http://ia.media-imdb.com/images/M/MV5BMTY3NDAyMjgwNl5BMl5BanBnXkFtZTcwMzk3MzcyMQ@@._V1._SY314_CR3,0,214,314_.jpg",1970,great_white_hope,5.5,6,2,4,33,0,3,1,2,33,3.8,213,74,http://content6.flixster.com/movie/63/07/18/6307184_det.jpg,-41
5773,Your Friends & Neighbors,119517,Amigos y vecinos,"http://ia.media-imdb.com/images/M/MV5BNzM0NDUwNDc5M15BMl5BanBnXkFtZTcwMjUyMjMyMQ@@._V1._SY314_CR4,0,214,314_.jpg",1998,your_friends_and_neighbors,7,55,42,13,76,6.4,20,13,7,65,3.3,1418,60,http://content7.flixster.com/movie/10/93/56/10935653_det.jpg,16
8749,La belle noiseuse,101428,La bella mentirosa,"http://ia.media-imdb.com/images/M/MV5BMTg4NjM3Mzg4OF5BMl5BanBnXkFtZTcwODYwNjUyMQ@@._V1._SX214_CR0,0,214,314_.jpg",1991,la_belle_noiseuse,8,22,22,0,100,8.2,6,6,0,100,3.9,797,83,http://content9.flixster.com/movie/29/45/294595_det.jpg,17
3927,Fantastic Voyage,60397,Viaje alucinante,"http://ia.media-imdb.com/images/M/MV5BMjE3Mjk5MDM3OF5BMl5BanBnXkFtZTcwOTYwNzY0MQ@@._V1._SY314_CR7,0,214,314_.jpg",1966,fantastic_voyage,7,25,23,2,92,0,3,3,0,100,3.3,1258,66,http://content8.flixster.com/movie/10/90/66/10906686_det.jpg,26
8039,Support Your Local Sheriff!,65051,También el Sheriff necesita ayuda,"http://ia.media-imdb.com/images/M/MV5BMTUyOTUzNTc5NV5BMl5BanBnXkFtZTcwMjM3MDYyMQ@@._V1._SY314_CR3,0,214,314_.jpg",1969,support_your_local_sheriff,6,11,7,4,63,0,1,0,1,0,3.6,1267,77,http://content9.flixster.com/movie/25/19/251995_det.jpg,-14
6663,The Pink Panther Strikes Again,75066,La pantera rosa ataca de nuevo,"http://ia.media-imdb.com/images/M/MV5BNDU5NjQwNjUyOF5BMl5BanBnXkFtZTcwMTQ1NTAyMQ@@._V1._SX214_CR0,0,214,314_.jpg",1976,pink_panther_strikes_again,7.1,17,14,3,82,0,1,0,1,0,3.4,5835,80,http://content6.flixster.com/movie/10/87/22/10872252_det.jpg,2
7188,The General,17925,El maquinista de la general,"http://ia.media-imdb.com/images/M/MV5BMTg5MjA1NjAyM15BMl5BanBnXkFtZTcwMTQyMjAwMg@@._V1._SY314_CR5,0,214,314_.jpg",1926,1008166-general,8.9,38,35,3,92,0,4,2,2,50,4.4,3785,93,http://content6.flixster.com/movie/10/84/02/10840232_det.jpg,-1
5310,Transylvania 6-5000,90196,Transylvania 6-5000,"http://ia.media-imdb.com/images/M/MV5BMTk4NTgxNjE2NV5BMl5BanBnXkFtZTcwMTgzNjEyMQ@@._V1._SY314_CR1,0,214,314_.jpg",1985,transylvania_65000,4.2,10,2,8,20,0,0,0,0,0,0,0,0,http://content7.flixster.com/movie/25/84/258493_det.jpg,20
6380,Capturing the Friedmans,342172,Capturing the Friedmans,"http://ia.media-imdb.com/images/M/MV5BMTIwOTY2NzU3NV5BMl5BanBnXkFtZTcwOTU5MDYyMQ@@._V1._SX214_CR0,0,214,314_.jpg",2003,capturing_the_friedmans,8.4,146,142,4,97,8.4,39,38,1,97,3.9,2794,87,http://content8.flixster.com/movie/10/93/45/10934558_det.jpg,10
6694,Tan de repente,324158,Tan de repente,"http://ia.media-imdb.com/images/M/MV5BODA0NjQ5ODA1Ml5BMl5BanBnXkFtZTcwNDQ3NjcyMQ@@._V1._SX214_CR0,0,214,314_.jpg",2002,1125073-suddenly,6.6,21,20,1,95,6.9,8,8,0,100,3.1,56,22,http://content9.flixster.com/movie/10/93/54/10935499_det.jpg,73
375,Safe Passage,111054,Tensa espera,"http://ia.media-imdb.com/images/M/MV5BMTg1MTMwMzk5Nl5BMl5BanBnXkFtZTcwMTE5MzUyMQ@@._V1._SY314_CR5,0,214,314_.jpg",1994,safe_passage,5.8,12,6,6,50,0,3,1,2,33,3.4,310,59,http://content8.flixster.com/movie/10/86/70/10867050_det.jpg,-9
824,Jeder für sich und Gott gegen alle,71691,El enigma de Gaspar Hauser,"http://ia.media-imdb.com/images/M/MV5BMTYxMjY2MDA4MF5BMl5BanBnXkFtZTYwMDk2Mzc5._V1._SX214_CR0,0,214,314_.jpg",1974,mystery-of-kaspar-hauser-jeder-fur-sich-und-gott-gegen-alle,0,0,0,0,0,0,0,0,0,0,0,0,0,http://images.rottentomatoescdn.com/images/defaults/poster_default.gif,0
58347,Penelope,472160,Penelope,"http://ia.media-imdb.com/images/M/MV5BMTc0MTYwNzQ5Nl5BMl5BanBnXkFtZTcwMjg2MzU1MQ@@._V1._SY314_CR1,0,214,314_.jpg",2006,penelope2008,5.6,125,65,60,52,5.4,28,14,14,50,3.6,48472,74,http://content7.flixster.com/movie/10/86/26/10862633_det.jpg,-22
8738,Une femme est une femme,55572,Una mujer es una mujer,"http://ia.media-imdb.com/images/M/MV5BMjA2MDEyMjQwMF5BMl5BanBnXkFtZTcwMTAyODUyMQ@@._V1._SY314_CR4,0,214,314_.jpg",1961,a-woman-is-a-woman,7.4,28,24,4,85,7.6,10,9,1,90,4,2893,86,http://content6.flixster.com/movie/10/92/44/10924424_det.jpg,-1
50158,Stomp the Yard,775539,Stomp the Yard,"http://ia.media-imdb.com/images/M/MV5BMTU5NDA4NDE2Ml5BMl5BanBnXkFtZTcwNDMxMDIzMw@@._V1._SY314_CR1,0,214,314_.jpg",2007,stomp_the_yard,4.5,88,23,65,26,4.7,27,8,19,29,3.8,131307,83,http://content7.flixster.com/movie/10/89/40/10894045_det.jpg,-57
3304,Blue Collar Comedy Tour: The Movie,330069,Blue Collar Comedy Tour: The Movie,"http://ia.media-imdb.com/images/M/MV5BMTQyNzY0ODA4Ml5BMl5BanBnXkFtZTYwOTc3MTg5._V1._SX214_CR0,0,214,314_.jpg",2003,blue_collar_comedy_tour_the_movie,6.8,13,12,1,92,7,8,8,0,100,3.6,6829,82,http://content6.flixster.com/movie/10/89/21/10892104_det.jpg,10
4661,Sea of Love,98273,Melodía de seducción,"http://ia.media-imdb.com/images/M/MV5BMTA5MDAwODcyNTVeQTJeQWpwZ15BbWU3MDQ4MTA2MjE@._V1._SY314_CR4,0,214,314_.jpg",1989,sea_of_love,7,19,16,3,84,0,1,1,0,100,3.3,3334,62,http://content9.flixster.com/movie/28/32/283295_det.jpg,22
3620,The Myth of Fingerprints,119746,Volviendo a casa,"http://ia.media-imdb.com/images/M/MV5BMjAxNTUxMDcyMl5BMl5BanBnXkFtZTcwNDExNzcxMQ@@._V1._SY314_CR2,0,214,314_.jpg",1997,myth_of_fingerprints,6,19,12,7,63,0,3,1,2,33,3.2,418,54,http://content7.flixster.com/movie/10/87/44/10874409_det.jpg,9
7444,13 Going on 30,337563,El sueño de mi vida,"http://ia.media-imdb.com/images/M/MV5BMjA1MTI3ODEwNF5BMl5BanBnXkFtZTcwOTA4NDUyMQ@@._V1._SY314_CR4,0,214,314_.jpg",2004,13_going_on_30,6.2,161,104,57,64,6.6,35,26,9,74,3.3,96034,70,http://content6.flixster.com/movie/10/93/55/10935508_det.jpg,-6
4334,Yi yi,244316,Yi yi,"http://ia.media-imdb.com/images/M/MV5BMjEwNjQ4MjQwMF5BMl5BanBnXkFtZTcwMTg0OTIzMQ@@._V1._SY314_CR4,0,214,314_.jpg",2000,the-last-days-of-hsin-yang,0,0,0,0,0,0,0,0,0,0,0,0,0,http://content9.flixster.com/movie/10/91/40/10914071_det.jpg,0
2329,American History X,120586,American History X,"http://ia.media-imdb.com/images/M/MV5BMTkwNjE3OTU5MV5BMl5BanBnXkFtZTcwMTM1Nzg0MQ@@._V1._SY314_CR4,0,214,314_.jpg",1998,american_history_x,7.2,72,60,12,83,6.6,21,15,6,71,4.2,140060,96,http://content9.flixster.com/movie/10/85/69/10856931_det.jpg,-13
52973,Knocked Up,478311,Un lío embarazoso,"http://ia.media-imdb.com/images/M/MV5BMTU1Njk0ODEwOF5BMl5BanBnXkFtZTYwMzA3ODc2._V1._SX214_CR0,0,214,314_.jpg",2007,what_up,0,1,0,1,0,0,0,0,0,0,0,0,0,http://content8.flixster.com/movie/10/88/41/10884170_det.jpg,0
49961,Notes on a Scandal,465551,Diario de un escándalo,"http://ia.media-imdb.com/images/M/MV5BMTY2NjcyOTE5Nl5BMl5BanBnXkFtZTcwNDQxNzkzMQ@@._V1._SX214_CR0,0,214,314_.jpg",2006,notes_on_a_scandal,7.5,167,145,22,86,8,36,33,3,91,3.7,22200,81,http://content7.flixster.com/movie/11/15/27/11152769_det.jpg,5
7345,Agent Cody Banks 2: Destination London,358349,Superagente Cody Banks 2,"http://ia.media-imdb.com/images/M/MV5BMjE4NDg4MDgxNF5BMl5BanBnXkFtZTcwMTc3NTQyMQ@@._V1._SX214_CR0,0,214,314_.jpg",2004,agent_cody_banks_2_destination_london,3.4,91,11,80,12,3.9,24,4,20,16,2.5,13037,41,http://content8.flixster.com/movie/10/87/57/10875718_det.jpg,-29
1716,"Other Voices, Other Rooms",119845,"Other Voices, Other Rooms","http://ia.media-imdb.com/images/M/MV5BMTQ3MjM2MTQ0M15BMl5BanBnXkFtZTYwMzc4Mjg5._V1._SY225_CR49,0,214,225_.jpg",1995,other_voices_other_rooms,0,1,0,1,0,0,0,0,0,0,0,0,0,http://content9.flixster.com/movie/11/00/80/11008071_det.jpg,0
4564,The First $20 Million Is Always the Hardest,280674,The First $20 Million Is Always the Hardest,"http://ia.media-imdb.com/images/M/MV5BMTczMjg4MTAxNl5BMl5BanBnXkFtZTYwMjM0OTc5._V1._SX214_CR0,0,214,314_.jpg",2002,first_20_million_is_always_the_hardest,2.4,9,1,8,11,0,2,0,2,0,3.2,483,50,http://content6.flixster.com/movie/26/67/266724_det.jpg,-39
26110,36 Hours,57809,36 horas,"http://ia.media-imdb.com/images/M/MV5BMTIwNzI1MjM4MF5BMl5BanBnXkFtZTcwMzA0NjQ0MQ@@._V1._SY314_CR17,0,214,314_.jpg",1965,1068456-36_hours,0,1,1,0,100,0,0,0,0,0,0,0,0,http://content6.flixster.com/movie/10/89/86/10898612_det.jpg,100
8879,Murder on the Orient Express,71877,Asesinato en el Orient Express,"http://ia.media-imdb.com/images/M/MV5BMjAzOTQ3MjU0Nl5BMl5BanBnXkFtZTcwNjA4ODYyMQ@@._V1._SY314_CR23,0,214,314_.jpg",1974,murder_on_the_orient_express,7.4,19,19,0,100,0,1,1,0,100,3.5,3826,74,http://content7.flixster.com/movie/10/86/79/10867929_det.jpg,26
3455,Buddy Boy,146516,Buddy Boy,"http://ia.media-imdb.com/images/M/MV5BNjU4NTMwNTQ3Nl5BMl5BanBnXkFtZTcwOTQwNjAzMQ@@._V1._SY314_CR4,0,214,314_.jpg",1999,buddy_boy,6.2,7,5,2,71,0,2,1,1,50,3.1,563,53,http://content7.flixster.com/movie/28/00/280029_det.jpg,18
7002,Mindwalk,100151,Mindwalk,"http://ia.media-imdb.com/images/M/MV5BMTgwMjY2NDQzM15BMl5BanBnXkFtZTcwNDg3NTAyMQ@@._V1._SX214_CR0,0,214,314_.jpg",1990,mind_walk,6.6,8,7,1,87,0,0,0,0,0,0,0,0,http://content7.flixster.com/movie/56/48/07/5648077_det.jpg,87
5168,Royal Wedding,43983,Bodas reales,"http://ia.media-imdb.com/images/M/MV5BMTM5MzQ4NTk1MV5BMl5BanBnXkFtZTcwNzkyMzU1MQ@@._V1._SY314_CR50,0,214,314_.jpg",1951,royal_wedding,6.7,14,12,2,85,0,0,0,0,0,0,0,0,http://content9.flixster.com/movie/30/76/307615_det.jpg,85
6032,A Little Romance,79477,Un pequeño romance,"http://ia.media-imdb.com/images/M/MV5BMjE2MzYxMjMyN15BMl5BanBnXkFtZTcwMjI0NjYxMQ@@._V1._SX214_CR0,0,214,314_.jpg",1979,1012506-little_romance,6.7,14,11,3,78,0,1,0,1,0,3.8,1363,79,http://content8.flixster.com/movie/10/91/32/10913278_det.jpg,-1
7383,Shade,323939,Shade,"http://ia.media-imdb.com/images/M/MV5BMzQxNDk2NjUxNF5BMl5BanBnXkFtZTcwMTY1MDYyMQ@@._V1._SX214_CR0,0,214,314_.jpg",2003,shade,5.8,15,10,5,66,0,3,2,1,66,3.3,1382,60,http://content9.flixster.com/movie/27/32/273295_det.jpg,6
5800,How to Murder Your Wife,58212,Cómo matar a la propia esposa,"http://ia.media-imdb.com/images/M/MV5BMTU4Mzk2NDg1OF5BMl5BanBnXkFtZTcwMjk1ODAwMQ@@._V1._SX214_CR0,0,214,314_.jpg",1965,how_to_murder_your_wife,5.9,8,5,3,62,0,0,0,0,0,0,0,0,http://content9.flixster.com/movie/10/87/56/10875691_det.jpg,62
3402,Turtle Diary,90219,El diario de la tortuga,"http://ia.media-imdb.com/images/M/MV5BMTk0ODgyMTc0NV5BMl5BanBnXkFtZTYwMDE3Mjg5._V1._SX214_CR0,0,214,314_.jpg",1985,turtle_diary,7.7,6,6,0,100,0,1,1,0,100,3.7,57,69,http://content6.flixster.com/movie/10/85/28/10852872_det.jpg,31
2926,Hairspray,427327,Hairspray,"http://ia.media-imdb.com/images/M/MV5BMTc3MjM4Njk4M15BMl5BanBnXkFtZTcwMzQ3NzU4MQ@@._V1._SY314_CR4,0,214,314_.jpg",2007,hairspray,7.7,205,186,19,90,8,41,40,1,97,3.9,382832,84,http://content6.flixster.com/movie/87/30/58/8730580_det.jpg,6
197,The Stars Fell on Henrietta,114534,Camino de la fortuna,"http://ia.media-imdb.com/images/M/MV5BMTU4NTYzMzIzMF5BMl5BanBnXkFtZTcwODk4MTkxMQ@@._V1._SX214_CR0,0,214,314_.jpg",1995,stars_fell_on_henrietta,4.9,7,2,5,28,0,1,0,1,0,3,66,18,http://content7.flixster.com/movie/10/85/18/10851893_det.jpg,10
52462,Aqua Teen Hunger Force Colon Movie Film for Theaters,455326,Aqua Teen Hunger Force Colon Movie Film for Theaters,"http://ia.media-imdb.com/images/M/MV5BMTc0OTQwNzYyNF5BMl5BanBnXkFtZTcwMDc5NTM0MQ@@._V1._SX214_CR0,0,214,314_.jpg",2007,aqua_teen_hunger_force_colon_movie_film_for_theatres,5.1,83,39,44,46,5.2,28,14,14,50,3.5,12293,68,http://content7.flixster.com/movie/61/11/86/6111861_det.jpg,-22
3068,The Verdict,84855,Veredicto final,"http://ia.media-imdb.com/images/M/MV5BMTg1NzA5MTQ0N15BMl5BanBnXkFtZTcwMDc1OTQ0MQ@@._V1._SY314_CR8,0,214,314_.jpg",1982,verdict,7.8,24,23,1,95,0,3,2,1,66,3.8,2332,85,http://content8.flixster.com/movie/10/92/11/10921162_det.jpg,10
4939,The Final Countdown,80736,El final de la cuenta atrás,"http://ia.media-imdb.com/images/M/MV5BMTY2MTk1NTMxNF5BMl5BanBnXkFtZTcwMjcxMDUyMQ@@._V1._SY314_CR4,0,214,314_.jpg",1980,final_countdown,5.5,10,5,5,50,0,1,0,1,0,3.4,1797,64,http://content7.flixster.com/movie/10/89/85/10898529_det.jpg,-14
45525,The Lost City,343996,La ciudad perdida,"http://ia.media-imdb.com/images/M/MV5BNjM4ODM1MTMzOF5BMl5BanBnXkFtZTcwMzY1NzczMQ@@._V1._SX214_CR0,0,214,314_.jpg",2005,10002516-lost_city,4.6,84,21,63,25,4.5,30,7,23,23,3.2,13324,50,http://content6.flixster.com/movie/11/14/23/11142384_det.jpg,-25
62010,Käsky,920461,Käsky,"http://ia.media-imdb.com/images/M/MV5BMTc3NzA5MzY0MF5BMl5BanBnXkFtZTcwNDIxNTQwMg@@._V1._SY314_CR3,0,214,314_.jpg",2008,kasky-tears-of-april,0,0,0,0,0,0,0,0,0,0,0,0,0,http://content8.flixster.com/movie/10/92/67/10926718_det.jpg,0
8496,The Panic in Needle Park,67549,Pánico en Needle Park,"http://ia.media-imdb.com/images/M/MV5BMTgxOTY5Mjk1NV5BMl5BanBnXkFtZTcwNzkyMjEzMQ@@._V1._SY314_CR1,0,214,314_.jpg",1971,1156599-panic_in_needle_park,7,9,7,2,77,0,1,1,0,100,3.6,1885,74,http://content9.flixster.com/movie/10/91/39/10913979_det.jpg,3
2072,The 'burbs,96734,No matarás al vecino,"http://ia.media-imdb.com/images/M/MV5BMTMwOTYzMTkzMl5BMl5BanBnXkFtZTcwMDI0OTUxMQ@@._V1._SY314_CR2,0,214,314_.jpg",1989,burbs,5.2,13,6,7,46,0,2,1,1,50,3.3,10248,68,http://content8.flixster.com/movie/55/12/57/5512574_det.jpg,-22
4457,Bianca Beauchamp All Access 2: Rubberized,1275532,Bianca Beauchamp All Access 2: Rubberized,"http://ia.media-imdb.com/images/M/MV5BMTI1ODQ1MjMzNF5BMl5BanBnXkFtZTcwOTY4OTY4MQ@@._V1._SY314_CR4,0,214,314_.jpg",2008,bianca-beauchamp-all-access-2-rubberized,0,0,0,0,0,0,0,0,0,0,0,0,0,http://content6.flixster.com/movie/10/88/44/10884416_det.jpg,0
7073,A Shot in the Dark,58586,El nuevo caso del inspector Clouseau,"http://ia.media-imdb.com/images/M/MV5BMTg4NjU1NDgwNV5BMl5BanBnXkFtZTcwODU3MTMyMQ@@._V1._SY314_CR0,0,214,314_.jpg",1964,1018909-shot_in_the_dark,7.9,20,20,0,100,0,0,0,0,0,0,0,0,http://content7.flixster.com/movie/26/13/261321_det.jpg,100
60647,Transsiberian,800241,Transsiberian,"http://ia.media-imdb.com/images/M/MV5BMTU2ODI4NDQ5MV5BMl5BanBnXkFtZTcwNDUyMzY2Mg@@._V1._SY314_CR4,0,214,314_.jpg",2008,transsiberian,7.2,75,68,7,90,7.3,17,16,1,94,3.4,6508,62,http://content7.flixster.com/movie/10/87/86/10878637_det.jpg,28
8256,Queen Christina,24481,La reina Cristina de Suecia,"http://ia.media-imdb.com/images/M/MV5BMjEzMTY2MzEwMV5BMl5BanBnXkFtZTcwNDM2NDAzMQ@@._V1._SY314_CR22,0,214,314_.jpg",1933,queen_christina,8.3,12,12,0,100,0,0,0,0,0,0,0,0,http://content9.flixster.com/movie/10/18/32/10183291_det.jpg,100
3433,Death Wish 4: The Crackdown,92857,Yo soy la justicia II,"http://ia.media-imdb.com/images/M/MV5BMTMyMzkyMDYxNF5BMl5BanBnXkFtZTcwMTM4NTQyMQ@@._V1._SY314_CR8,0,214,314_.jpg",1987,death_wish_4_the_crackdown,3.8,6,1,5,16,0,0,0,0,0,0,0,0,http://content9.flixster.com/movie/10/88/14/10881499_det.jpg,16
5152,We Were Soldiers,277434,Cuando éramos soldados,"http://ia.media-imdb.com/images/M/MV5BMTY3ODk4MTc5Nl5BMl5BanBnXkFtZTcwNTk2MTUyMQ@@._V1._SX214_CR0,0,214,314_.jpg",2002,we_were_soldiers,6.4,141,88,53,62,6.9,36,27,9,75,3.6,36901,84,http://content6.flixster.com/movie/10/92/29/10922992_det.jpg,-22
7756,Aleksandr Nevskiy,29850,Aleksandr Nevskiy,"http://ia.media-imdb.com/images/M/MV5BMTkxMTcxMTc5NV5BMl5BanBnXkFtZTcwNzgyNDAyMQ@@._V1._SY314_CR7,0,214,314_.jpg",1938,aleksandr-nevskiy-alexander-nevsky,8.7,16,15,1,93,0,3,2,1,66,4,1217,82,http://content7.flixster.com/movie/30/26/302613_det.jpg,11
4054,Save the Last Dance,206275,Espera al último baile,"http://ia.media-imdb.com/images/M/MV5BMTcxNzI0ODQ4Ml5BMl5BanBnXkFtZTcwMzA0NzgzMQ@@._V1._SY314_CR4,0,214,314_.jpg",2001,save_the_last_dance_for_me,0,0,0,0,0,0,0,0,0,0,0,0,0,http://content7.flixster.com/movie/10/87/40/10874033_det.jpg,0
6739,At War with the Army,42209,At War with the Army,"http://ia.media-imdb.com/images/M/MV5BMjE4MzI1OTgwMV5BMl5BanBnXkFtZTcwMzQ1MzU1MQ@@._V1._SY314_CR50,0,214,314_.jpg",1950,at_war_with_the_army,0,2,0,2,0,0,0,0,0,0,0,0,0,http://content8.flixster.com/movie/31/14/311406_det.jpg,0
60894,The Edge of Love,819714,The Edge of Love,"http://ia.media-imdb.com/images/M/MV5BMTI5MjcxNDQxMl5BMl5BanBnXkFtZTcwNzQxNjA1Mg@@._V1._SY314_CR2,0,214,314_.jpg",2008,edge_of_love,5.1,55,20,35,36,4.5,13,4,9,30,3,18391,45,http://content7.flixster.com/movie/10/88/25/10882585_det.jpg,-9
53121,Shrek the Third,413267,Shrek tercero,"http://ia.media-imdb.com/images/M/MV5BMTMyMjE1Mjc1NF5BMl5BanBnXkFtZTcwMzY0MjEzMw@@._V1._SX214_CR0,0,214,314_.jpg",2007,shrek_3,5.5,203,83,120,40,5.7,39,19,20,48,3.4,1369685,57,http://content9.flixster.com/movie/59/86/40/5986403_det.jpg,-17
4441,Game of Death,77594,Juego con la muerte,"http://ia.media-imdb.com/images/M/MV5BMTc5ODYxNDM5MV5BMl5BanBnXkFtZTcwMDQ5NzQzMQ@@._V1._SY314_CR7,0,214,314_.jpg",1978,1008085-game_of_death,6,8,6,2,75,0,0,0,0,0,0,0,0,http://content7.flixster.com/movie/11/12/60/11126073_det.jpg,75
8926,Circle of Iron,78975,El círculo de hierro,"http://ia.media-imdb.com/images/M/MV5BMTQ5MzQ0NzUxNF5BMl5BanBnXkFtZTYwODU1Mjg5._V1._SX214_CR0,0,214,314_.jpg",1978,circle_of_iron,4.6,7,3,4,42,0,0,0,0,0,0,0,0,http://content9.flixster.com/movie/10/87/62/10876267_det.jpg,42
7023,Xi yan,107156,El banquete de boda,"http://ia.media-imdb.com/images/M/MV5BMTI5OTc1NDM5Ml5BMl5BanBnXkFtZTcwNTQxNDUyMQ@@._V1._SY314_CR8,0,214,314_.jpg",1993,wedding_banquet,7.5,16,15,1,93,0,2,2,0,100,3.9,2178,86,http://content9.flixster.com/movie/11/12/06/11120683_det.jpg,7
389,Le colonel Chabert,109454,El coronel Chabert,"http://ia.media-imdb.com/images/M/MV5BMTM1NTEyNjQ3MF5BMl5BanBnXkFtZTcwMzg4NTYxMQ@@._V1._SX214_CR0,0,214,314_.jpg",1994,1058427-colonel_chabert,7.1,6,5,1,83,0,1,1,0,100,3.6,142,59,http://content6.flixster.com/movie/10/92/93/10929336_det.jpg,24
48738,The Last King of Scotland,455590,El último rey de Escocia,"http://ia.media-imdb.com/images/M/MV5BMTU4MDMzNTYwNV5BMl5BanBnXkFtZTcwOTMwODM0MQ@@._V1._SY314_CR11,0,214,314_.jpg",2006,last_king_of_scotland,7.3,177,154,23,87,7.4,40,36,4,90,3.8,58962,87,http://content9.flixster.com/movie/27/22/94/2722943_det.jpg,0
2638,The Mummy: Tomb of the Dragon Emperor,859163,La momia - La tumba del emperador dragón,"http://ia.media-imdb.com/images/M/MV5BMjIxMzg1OTAwOV5BMl5BanBnXkFtZTcwMTgwNzEwMg@@._V1._SY314_CR5,0,214,314_.jpg",2008,mummy_tomb_of_the_dragon_emperor,3.7,161,21,140,13,3.7,32,3,29,9,3,79989,40,http://content8.flixster.com/movie/10/87/58/10875846_det.jpg,-27
26693,It,99864,It,"http://ia.media-imdb.com/images/M/MV5BMTM5ODU3MTc5M15BMl5BanBnXkFtZTcwMTY3MTEyMQ@@._V1._SY314_CR1,0,214,314_.jpg",1990,stephen-kings-it1990,5.6,10,7,3,70,0,0,0,0,0,0,0,0,http://content8.flixster.com/movie/28/59/285922_det.jpg,70
33164,House of Wax,397065,La casa de cera,"http://ia.media-imdb.com/images/M/MV5BNDA4Nzg1NjQ2NV5BMl5BanBnXkFtZTcwMDYwNTgyMQ@@._V1._SX214_CR0,0,214,314_.jpg",2005,house_of_wax,4.3,148,37,111,25,4.5,30,6,24,20,2.8,39495,54,http://content9.flixster.com/movie/10/92/43/10924347_det.jpg,-29
582,Métisse,107642,Métisse,"http://ia.media-imdb.com/images/M/MV5BMTkzMDk4MDMzMl5BMl5BanBnXkFtZTcwMTU4ODgyMQ@@._V1._SY314_CR7,0,214,314_.jpg",1993,cafe_au_lait,5.9,6,4,2,66,0,2,1,1,50,0,0,0,http://content8.flixster.com/movie/10/89/42/10894274_det.jpg,66
710,Celtic Pride,115851,Celtic Pride,"http://ia.media-imdb.com/images/M/MV5BMTIxNjUwMTM1NV5BMl5BanBnXkFtZTcwOTgxNzUyMQ@@._V1._SY314_CR4,0,214,314_.jpg",1996,celtic_pride,3.1,23,2,21,8,4.5,7,2,5,28,2.6,1756,30,http://content8.flixster.com/movie/95/04/97/9504978_det.jpg,-22
5961,Blue Steel,99160,Acero azul,"http://ia.media-imdb.com/images/M/MV5BMjAxOTY3NDYyNl5BMl5BanBnXkFtZTcwNTk1NzAyMQ@@._V1._SY314_CR2,0,214,314_.jpg",1989,1028554-blue_steel,5.9,16,12,4,75,0,2,2,0,100,2.8,1502,32,http://content8.flixster.com/movie/11/13/20/11132034_det.jpg,43
6080,Forced Vengeance,83960,Marcado para morir,"http://ia.media-imdb.com/images/M/MV5BMTM2NDExNDIxMV5BMl5BanBnXkFtZTcwODQ5NDgyMQ@@._V1._SY314_CR22,0,214,314_.jpg",1982,forced_vengeance,0,0,0,0,0,0,0,0,0,0,0,0,0,http://content8.flixster.com/movie/10/27/87/10278786_det.jpg,0
6915,Chicago Joe and the Showgirl,99250,El gángster y la corista,"http://ia.media-imdb.com/images/M/MV5BMjA5OTg3ODcyN15BMl5BanBnXkFtZTcwNjIzMDcyMQ@@._V1._SX214_CR0,0,214,314_.jpg",1990,chicago_joe_and_the_showgirl,0,4,1,3,25,0,1,0,1,0,2.9,170,31,http://content9.flixster.com/movie/44/92/53/4492531_det.jpg,-6
7293,50 First Dates,343660,50 primeras citas,"http://ia.media-imdb.com/images/M/MV5BMjAwMzc4MDgxNF5BMl5BanBnXkFtZTYwNjUwMzE3._V1._SX214_CR0,0,214,314_.jpg",2004,50_first_dates,5.4,172,76,96,44,5.3,38,18,20,47,3.4,217959,68,http://content6.flixster.com/movie/11/15/32/11153208_det.jpg,-24
6407,Walk Don't Run,61170,Apartamento para tres,"http://ia.media-imdb.com/images/M/MV5BMTE5OTkxMTczMl5BMl5BanBnXkFtZTcwOTM5NDQyMQ@@._V1._SY314_CR0,0,214,314_.jpg",1966,walk_dont_run,6.4,5,4,1,80,0,0,0,0,0,0,0,0,http://content9.flixster.com/movie/29/49/294923_det.jpg,80
3840,Pumpkinhead,95925,Pacto de sangre,"http://ia.media-imdb.com/images/M/MV5BODQ4MDU2MDAzMF5BMl5BanBnXkFtZTcwODUyNTcxMQ@@._V1._SY314_CR1,0,214,314_.jpg",1988,pumpkinhead,5.3,16,9,7,56,0,1,0,1,0,2.9,3312,52,http://content9.flixster.com/movie/27/06/270611_det.jpg,4
6458,The Blue Max,60177,Las águilas azules,"http://ia.media-imdb.com/images/M/MV5BMjAzMjY2MzEwM15BMl5BanBnXkFtZTYwNTg0OTk5._V1._SY314_CR6,0,214,314_.jpg",1966,blue_max,0,4,4,0,100,0,0,0,0,0,0,0,0,http://content8.flixster.com/movie/28/61/286126_det.jpg,100
793,En compagnie d'Antonin Artaud,106810,En compagnie d'Antonin Artaud,"http://ia.media-imdb.com/images/M/MV5BMTM2MjE5MTQ5MF5BMl5BanBnXkFtZTcwOTMzNzcyMQ@@._V1._SX214_CR0,0,214,314_.jpg",1993,artaud,6.9,6,5,1,83,0,2,1,1,50,0,0,0,http://content9.flixster.com/movie/11/02/74/11027443_det.jpg,83
7923,Rolling Thunder,76637,El expreso de Corea,"http://ia.media-imdb.com/images/M/MV5BMTE5ODg4ODAwN15BMl5BanBnXkFtZTYwMDk1OTg5._V1._SX214_CR0,0,214,314_.jpg",1977,1017818-rolling_thunder,6.9,5,5,0,100,0,0,0,0,0,0,0,0,http://content7.flixster.com/movie/51/24/54/5124545_det.jpg,100
5222,Kissing Jessica Stein,264761,Besando a Jessica Stein,"http://ia.media-imdb.com/images/M/MV5BMTQyODA0NTc4OF5BMl5BanBnXkFtZTcwMjc0MDEyMQ@@._V1._SY314_CR7,0,214,314_.jpg",2001,kissing_jessica_stein,7,115,97,18,84,7.6,30,27,3,90,3.2,3869,61,http://content6.flixster.com/movie/26/99/269904_det.jpg,23
3865,The Original Kings of Comedy,236388,The Original Kings of Comedy,"http://ia.media-imdb.com/images/M/MV5BMTI5NDY1NDU1M15BMl5BanBnXkFtZTcwODcyNTMyMQ@@._V1._SY314_CR4,0,214,314_.jpg",2000,original_kings_of_comedy,6.9,87,75,12,86,7.1,29,26,3,89,3.7,3266,81,http://content7.flixster.com/movie/11/14/72/11147213_det.jpg,5
7887,But I'm a Cheerleader,179116,But I'm a Cheerleader,"http://ia.media-imdb.com/images/M/MV5BMjEyMDM3MjMyNF5BMl5BanBnXkFtZTcwMjY3ODUyMQ@@._V1._SX214_CR0,0,214,314_.jpg",1999,but_im_a_cheerleader,4.7,46,15,31,32,4.1,12,3,9,25,3.4,7081,74,http://content8.flixster.com/movie/27/53/275310_det.jpg,-42
111,Taxi Driver,75314,Taxi Driver,"http://ia.media-imdb.com/images/M/MV5BMTQ1Nzg3MDQwN15BMl5BanBnXkFtZTcwNDE2NDU2MQ@@._V1._SY314_CR8,0,214,314_.jpg",1976,taxi_driver,8.7,50,49,1,98,7.7,9,8,1,88,4.1,58145,93,http://content9.flixster.com/movie/10/91/39/10913987_det.jpg,5
57865,The Pleasure of Your Company,484877,The Pleasure of Your Company,"http://ia.media-imdb.com/images/M/MV5BMTI4Mzc3MTU1N15BMl5BanBnXkFtZTcwNTM3MTM1MQ@@._V1._SY314_CR128,0,214,314_.jpg",2006,pleasure_of_your_company,4.3,11,4,7,36,0,1,0,1,0,2.9,7325,40,http://content7.flixster.com/movie/85/18/88/8518881_det.jpg,-4
63617,Christmas on Mars,363240,Christmas on Mars,"http://ia.media-imdb.com/images/M/MV5BMTYzNjQ3MzE3MV5BMl5BanBnXkFtZTcwMDY2MDg4MQ@@._V1._SX214_CR0,0,214,314_.jpg",2008,christmas_on_mars,5.5,6,3,3,50,0,4,2,2,50,3.3,530,56,http://content6.flixster.com/movie/10/88/98/10889800_det.jpg,-6
52950,Dnevnoy dozor,409904,Guardianes del día,"http://ia.media-imdb.com/images/M/MV5BMzExNTgzMTg4Nl5BMl5BanBnXkFtZTYwMTY0Nzc2._V1._SX214_CR0,0,214,314_.jpg",2006,day_watch,5.9,95,60,35,63,6.2,23,18,5,78,3.5,13807,69,http://content9.flixster.com/movie/75/28/34/7528347_det.jpg,-6
6307,The Iceman Cometh,70212,The Iceman Cometh,"http://ia.media-imdb.com/images/M/MV5BNjc5NjU1OTg0MF5BMl5BanBnXkFtZTcwODMwOTI0MQ@@._V1._SY314_CR4,0,214,314_.jpg",1973,1120594-iceman_cometh,6.9,8,7,1,87,6.9,5,4,1,80,3.8,322,67,http://content7.flixster.com/movie/57/04/86/5704865_det.jpg,20
2171,Next Stop Wonderland,119778,Próxima parada Wonderland,"http://ia.media-imdb.com/images/M/MV5BMTY0MTA4NzQ1OF5BMl5BanBnXkFtZTcwOTE5MTcxMQ@@._V1._SY314_CR4,0,214,314_.jpg",1998,next_stop_wonderland,6.8,41,30,11,73,5.7,7,3,4,42,3.5,910,70,http://content7.flixster.com/movie/10/86/22/10862269_det.jpg,3
48082,La science des rêves,354899,La ciencia del sueño,"http://ia.media-imdb.com/images/M/MV5BMTg3NTcxNzY5NV5BMl5BanBnXkFtZTcwODk5NTQzMQ@@._V1._SX214_CR0,0,214,314_.jpg",2006,the_science_of_sleep,6.6,153,107,46,69,6.5,34,23,11,67,3.8,53923,81,http://content6.flixster.com/movie/10/89/25/10892548_det.jpg,-12
2719,The Haunting,171363,La guarida,"http://ia.media-imdb.com/images/M/MV5BMTQ1MzU1MTU3Ml5BMl5BanBnXkFtZTcwOTA0MjMyMQ@@._V1._SY314_CR8,0,214,314_.jpg",1999,1090789-haunting,3.7,87,15,72,17,3.1,24,3,21,12,2.7,10812,42,http://content7.flixster.com/movie/10/81/95/10819505_det.jpg,-25
787,The Gate of Heavenly Peace,113147,The Gate of Heavenly Peace,"http://ia.media-imdb.com/images/M/MV5BMjE1MzgyMjQ4Ml5BMl5BanBnXkFtZTcwMDgxNDQ0MQ@@._V1._SY314_CR50,0,214,314_.jpg",1995,gate_of_heavenly_peace,0,1,1,0,100,0,0,0,0,0,0,0,0,http://images.rottentomatoescdn.com/images/defaults/poster_default.gif,100
2168,Dance with Me,120576,Baila conmigo,"http://ia.media-imdb.com/images/M/MV5BMTc1OTE4NDMxNV5BMl5BanBnXkFtZTcwODQzMjIyMQ@@._V1._SY314_CR1,0,214,314_.jpg",1998,dance_with_me,5.4,40,19,21,47,5.2,11,5,6,45,3.2,7621,68,http://content9.flixster.com/movie/25/56/255603_det.jpg,-21
2619,Mascara,93504,Maquillaje para matar,"http://ia.media-imdb.com/images/M/MV5BMjc0MjU1NDkxN15BMl5BanBnXkFtZTcwMTQ5NjEyMQ@@._V1._SX214_CR0,0,214,314_.jpg",1987,1013470-mascara,0,0,0,0,0,0,0,0,0,0,0,0,0,http://content8.flixster.com/movie/10/89/46/10894674_det.jpg,0
8206,Mystery of the Wax Museum,24368,Los crímenes del museo,http://ia.media-imdb.com/images/M/MV5BMTQ3NDc4ODYzNV5BMl5BanBnXkFtZTcwMTcyOTMyMQ@@._V1._SX77_SY140_.jpg,1933,mystery_of_the_wax_museum,7.4,8,8,0,100,0,0,0,0,0,0,0,0,http://content7.flixster.com/movie/10/25/32/10253229_det.jpg,100
34532,The Skeleton Key,397101,La llave del mal,"http://ia.media-imdb.com/images/M/MV5BMTMxNDYzODE3NF5BMl5BanBnXkFtZTcwMDc1NDAzMQ@@._V1._SX214_CR0,0,214,314_.jpg",2005,1149472-skeleton_key,5.3,147,56,91,38,5,33,8,25,24,3.1,23528,63,http://content7.flixster.com/movie/24/99/249993_det.jpg,-25
6969,Le dernier combat,85426,Kamikaze 1999,"http://ia.media-imdb.com/images/M/MV5BMTg4OTg5NTM0N15BMl5BanBnXkFtZTcwMTEyOTQyMQ@@._V1._SY314_CR4,0,214,314_.jpg",1983,le_dernier_combat,0,3,2,1,66,0,0,0,0,0,0,0,0,http://content8.flixster.com/movie/10/92/20/10922098_det.jpg,66
4561,Waxwork,96426,Waxwork: Museo de cera,"http://ia.media-imdb.com/images/M/MV5BMTI5MDAxMTg3MV5BMl5BanBnXkFtZTcwOTk2NzgyMQ@@._V1._SY314_CR0,0,214,314_.jpg",1988,waxwork,4.7,9,5,4,55,0,0,0,0,0,0,0,0,http://content7.flixster.com/movie/17/87/69/1787697_det.jpg,55
61401,The Spirit,831887,The Spirit,"http://ia.media-imdb.com/images/M/MV5BMTk0NjgzMjU2NF5BMl5BanBnXkFtZTcwNTczMDY0Mg@@._V1._SY314_CR19,0,214,314_.jpg",2008,the_spirit,3.6,108,16,92,14,3.4,27,2,25,7,2.6,56971,30,http://content7.flixster.com/movie/10/87/76/10877625_det.jpg,-16
25771,Un chien andalou,20530,Un perro andaluz,"http://ia.media-imdb.com/images/M/MV5BMTI1NDA0NDQ2M15BMl5BanBnXkFtZTcwMzAwODQyMQ@@._V1._SX214_CR0,0,214,314_.jpg",1929,un-chien-andalou-an-andalusian-dog,9.2,18,18,0,100,0,3,3,0,100,4.1,5685,86,http://content7.flixster.com/movie/29/12/291229_det.jpg,14
6332,The Lizzie McGuire Movie,306841,Lizzie Superstar,"http://ia.media-imdb.com/images/M/MV5BMTQ2MzQyNjEzMV5BMl5BanBnXkFtZTcwNzg1MTQyMQ@@._V1._SX214_CR0,0,214,314_.jpg",2003,lizzie_mcguire_movie,5.4,96,38,58,39,5.7,29,16,13,55,2.7,32236,57,http://content9.flixster.com/movie/31/93/91/3193911_det.jpg,-18
20,Money Train,113845,Asalto al tren del dinero,"http://ia.media-imdb.com/images/M/MV5BNDEwNzcyNjkzNl5BMl5BanBnXkFtZTcwNzQyMzYxMQ@@._V1._SY314_CR4,0,214,314_.jpg",1995,money_train,4,24,4,20,16,4.5,5,1,4,20,2.7,5263,38,http://content9.flixster.com/movie/11/12/51/11125103_det.jpg,-22
3037,Little Big Man,65988,Pequeño gran hombre,"http://ia.media-imdb.com/images/M/MV5BNDI3NzMzNjgzMF5BMl5BanBnXkFtZTcwMzQwNTEzMQ@@._V1._SY314_CR4,0,214,314_.jpg",1970,little_big_man,7.9,25,24,1,96,0,2,2,0,100,3.8,3720,84,http://content8.flixster.com/movie/10/91/68/10916850_det.jpg,12
8827,Bill Cosby: Himself,83652,Bill Cosby: Himself,"http://ia.media-imdb.com/images/M/MV5BMTUyMjg0NjgyOV5BMl5BanBnXkFtZTcwNzE2OTczMQ@@._V1._SY314_CR7,0,214,314_.jpg",1983,bill_cosby_himself,7,5,4,1,80,0,0,0,0,0,0,0,0,http://content8.flixster.com/movie/20/53/43/2053434_det.jpg,80
50162,Arthur et les Minimoys,344854,Arthur et les Minimoys,"http://ia.media-imdb.com/images/M/MV5BMTcxOTgyMjExMV5BMl5BanBnXkFtZTcwNDg2MTg0MQ@@._V1._SY314_CR4,0,214,314_.jpg",2006,10004659-arthur,4.5,90,19,71,21,4.2,25,4,21,16,3.2,25956,62,http://content8.flixster.com/movie/10/88/99/10889946_det.jpg,-41
1047,The Long Kiss Goodnight,116908,Memoria letal,"http://ia.media-imdb.com/images/M/MV5BMTUxMTY5MDE0OF5BMl5BanBnXkFtZTcwMzU5NjgxMQ@@._V1._SY314_CR7,0,214,314_.jpg",1996,long_kiss_goodnight,6.1,29,20,9,68,4.1,6,0,6,0,3.3,10833,69,http://content8.flixster.com/movie/59/86/77/5986778_det.jpg,-1
4737,An American Rhapsody,221799,La pesadilla de Susi,"http://ia.media-imdb.com/images/M/MV5BMjE0Mzk2MTkxNV5BMl5BanBnXkFtZTcwOTE4MDYyMQ@@._V1._SX214_CR0,0,214,314_.jpg",2001,1117045-rhapsody,0,0,0,0,0,0,0,0,0,0,0,0,0,http://content6.flixster.com/movie/10/84/97/10849776_det.jpg,0
6313,Sibling Rivalry,100611,Hay un muerto en mi cama,"http://ia.media-imdb.com/images/M/MV5BMTIyMTIyNTA4MF5BMl5BanBnXkFtZTcwODMxMjIyMQ@@._V1._SY314_CR2,0,214,314_.jpg",1990,1030709-sibling_rivalry,3.5,8,1,7,12,0,2,0,2,0,2.8,481,33,http://content9.flixster.com/movie/26/38/263891_det.jpg,-21
60405,The Game,119174,The Game,"http://ia.media-imdb.com/images/M/MV5BNTQyNjcxNDg0M15BMl5BanBnXkFtZTcwNjE2MzIyMQ@@._V1._SY314_CR0,0,214,314_.jpg",1997,1078955-game,7.2,43,30,13,69,7.2,11,7,4,63,3.5,23139,82,http://content9.flixster.com/movie/28/04/280403_det.jpg,-13
6484,Hollywood Homicide,329717,Hollywood: Departamento de homicidios,"http://ia.media-imdb.com/images/M/MV5BMTM2NTQ0NTA3Ml5BMl5BanBnXkFtZTcwNzcyMTYyMQ@@._V1._SX214_CR0,0,214,314_.jpg",2003,hollywood_homicide,4.7,158,47,111,29,4.8,37,10,27,27,2.6,6121,32,http://content8.flixster.com/movie/10/84/02/10840222_det.jpg,-3
5803,I Spy,297181,Soy espía,"http://ia.media-imdb.com/images/M/MV5BMjEzMzYxMDkwMV5BMl5BanBnXkFtZTcwOTYyMTUyMQ@@._V1._SY314_CR0,0,214,314_.jpg",2002,hit-me,0,0,0,0,0,0,0,0,0,0,0,0,0,http://content8.flixster.com/movie/10/89/32/10893214_det.jpg,0
1266,Unforgiven,105695,Sin perdón,"http://ia.media-imdb.com/images/M/MV5BMTM2MjExNTEwMV5BMl5BanBnXkFtZTcwMzIyMDEyMQ@@._V1._SY314_CR10,0,214,314_.jpg",1992,1041911-unforgiven,8.5,56,54,2,96,7.5,11,9,2,81,4,27203,91,http://content9.flixster.com/movie/10/93/21/10932195_det.jpg,5
877,Girls Town,116418,Girls Town,"http://ia.media-imdb.com/images/M/MV5BMTkyMDMxMDcwN15BMl5BanBnXkFtZTcwMDc3MTgxMQ@@._V1._SX214_CR0,0,214,314_.jpg",1996,1072971-girls_town,6.8,23,20,3,86,7,10,9,1,90,3.8,173,76,http://content9.flixster.com/movie/66/25/56/6625567_det.jpg,10
2073,Fandango,89126,¿Dónde dices que vas?,"http://ia.media-imdb.com/images/M/MV5BMTY2MzI5Mjc0MF5BMl5BanBnXkFtZTcwOTUyNTk4Mw@@._V1._SY314_CR50,0,214,314_.jpg",1985,1007073-fandango,6.3,6,3,3,50,0,0,0,0,0,0,0,0,http://content7.flixster.com/movie/80/53/86/8053869_det.jpg,50
2545,Relax... It's Just Sex,159696,Tú tranqui... es sólo sexo!,"http://ia.media-imdb.com/images/M/MV5BMjE3NTk5OTAwNF5BMl5BanBnXkFtZTcwNDE3OTYyMQ@@._V1._SY314_CR3,0,214,314_.jpg",1998,relax_its_just_sex,5.9,16,8,8,50,0,3,2,1,66,3.4,732,64,http://content7.flixster.com/movie/28/36/283605_det.jpg,-14
4774,Big Trouble,246464,El gran lío,"http://ia.media-imdb.com/images/M/MV5BMTIzMjQyMzgwMV5BMl5BanBnXkFtZTcwODM0ODkxMQ@@._V1._SY314_CR8,0,214,314_.jpg",2002,1109942-big_trouble,5.4,110,53,57,48,4.8,31,9,22,29,2.9,3336,52,http://content9.flixster.com/movie/10/92/12/10921251_det.jpg,-4
5144,The Lone Ranger and the Lost City of Gold,51876,The Lone Ranger and the Lost City of Gold,"http://ia.media-imdb.com/images/M/MV5BNzk2MjcxNDA3OV5BMl5BanBnXkFtZTcwNTQ5MTEyMQ@@._V1._SY314_CR10,0,214,314_.jpg",1958,lone_ranger_and_the_lost_city_of_gold,0,4,2,2,50,0,0,0,0,0,0,0,0,http://content6.flixster.com/movie/11/14/23/11142388_det.jpg,50
49132,Shut Up & Sing,811136,Shut Up & Sing,"http://ia.media-imdb.com/images/M/MV5BMTQwODM0NzM1NV5BMl5BanBnXkFtZTcwNDY0NTkzMQ@@._V1._SX214_CR0,0,214,314_.jpg",2006,limit-21-realtime,0,0,0,0,0,0,0,0,0,0,0,0,0,http://content8.flixster.com/movie/10/88/37/10883742_det.jpg,0
2786,Haunted Honeymoon,91178,Terrorífica luna de miel,"http://ia.media-imdb.com/images/M/MV5BMTM2NTM2MDM2NV5BMl5BanBnXkFtZTYwNTc2Nzg4._V1._SY314_CR1,0,214,314_.jpg",1986,haunted_honeymoon,3.5,8,2,6,25,0,0,0,0,0,0,0,0,http://content6.flixster.com/movie/10/89/43/10894380_det.jpg,25
5047,Kung Pow: Enter the Fist,240468,Kung Pow: A puñetazo limpio,"http://ia.media-imdb.com/images/M/MV5BMTYyODQwODY1N15BMl5BanBnXkFtZTcwNzE3ODI1MQ@@._V1._SY314_CR8,0,214,314_.jpg",2002,kung_pow,2.8,53,6,47,11,2.8,12,0,12,0,3,15128,64,http://content7.flixster.com/movie/10/87/79/10877913_det.jpg,-53
4003,She's Having a Baby,96094,La loca aventura del matrimonio,"http://ia.media-imdb.com/images/M/MV5BMTIzMzI3NjA1M15BMl5BanBnXkFtZTcwNDkyMjkyMQ@@._V1._SY314_CR2,0,214,314_.jpg",1988,shes_having_a_baby,5.4,20,10,10,50,0,1,0,1,0,3.1,2609,48,http://content7.flixster.com/movie/25/90/259009_det.jpg,2
1045,Love Is All There Is,116928,Love Is All There Is,"http://ia.media-imdb.com/images/M/MV5BMTIwNzQ1NDI5MV5BMl5BanBnXkFtZTcwODY2NzQyMQ@@._V1._SY314_CR2,0,214,314_.jpg",1996,love_is_all_there_is,0,2,0,2,0,0,0,0,0,0,0,0,0,http://content6.flixster.com/movie/27/61/276104_det.jpg,0
287,Nina Takes a Lover,110671,Nina takes a lover: Nina se busca un amante,"http://ia.media-imdb.com/images/M/MV5BMTY1MTU5Nzc3N15BMl5BanBnXkFtZTcwNzY4MTUyMQ@@._V1._SY314_CR0,0,214,314_.jpg",1994,nina_takes_a_lover,5.2,6,3,3,50,0,2,0,2,0,3.4,125,52,http://content8.flixster.com/movie/62/32/18/6232186_det.jpg,-2
46559,The Road to Guantanamo,468094,Camino a Guantánamo,"http://ia.media-imdb.com/images/M/MV5BMTQ2Njk1NDg0MV5BMl5BanBnXkFtZTcwMzQ2MTMzMQ@@._V1._SX214_CR0,0,214,314_.jpg",2006,road_to_guantanamo,7.1,94,81,13,86,7,30,25,5,83,3.4,13498,63,http://content9.flixster.com/movie/10/89/10/10891003_det.jpg,23
4035,The Claim,218378,El perdón,http://ia.media-imdb.com/images/M/MV5BMTM1MzIxMzQ3Nl5BMl5BanBnXkFtZTcwMTU5MjUxMQ@@._V1._SX98_SY140_.jpg,2000,claim,5.8,83,52,31,62,6.2,28,18,10,64,3.1,892,46,http://content7.flixster.com/movie/28/22/282225_det.jpg,16
1849,Prince Valiant,47365,El príncipe valiente,"http://ia.media-imdb.com/images/M/MV5BMTAzNzE5MjgyNzReQTJeQWpwZ15BbWU3MDYxNDM1MjE@._V1._SY314_CR3,0,214,314_.jpg",1954,1033462-prince_valiant,0,0,0,0,0,0,0,0,0,0,0,0,0,http://content9.flixster.com/movie/25/83/258391_det.jpg,0
33585,9 Songs,411705,9 Songs,"http://ia.media-imdb.com/images/M/MV5BMTM3ODc4MTI2OV5BMl5BanBnXkFtZTcwMTA4NjUzMQ@@._V1._SY314_CR4,0,214,314_.jpg",2004,9_songs,4.4,92,23,69,25,4.5,29,8,21,27,2.7,3152,35,http://content7.flixster.com/movie/28/57/285721_det.jpg,-10
7093,The Front Page,71524,Primera plana,"http://ia.media-imdb.com/images/M/MV5BNTA1NTIyMzM4OF5BMl5BanBnXkFtZTcwNDgxODgyMQ@@._V1._SY314_CR3,0,214,314_.jpg",1974,1037105-front_page,5.8,24,16,8,66,0,1,1,0,100,3.6,905,73,http://content9.flixster.com/movie/10/91/11/10911135_det.gif,-7
65091,Manhattan Melodrama,25464,El enemigo público número 1,http://ia.media-imdb.com/images/M/MV5BMTUyODE3Nzc4Nl5BMl5BanBnXkFtZTcwMTAwMTQyMQ@@._V1._SX77_SY140_.jpg,1934,manhattan_melodrama,7,12,10,2,83,0,4,2,2,50,3.7,344,71,http://content9.flixster.com/movie/66/44/64/6644647_det.jpg,12
1407,Scream,117571,Scream: Vigila quién llama,"http://ia.media-imdb.com/images/M/MV5BMTgwODk4NjIwNF5BMl5BanBnXkFtZTYwMzIyMjg4._V1._SX214_CR0,0,214,314_.jpg",1996,1074316-scream,7,53,43,10,81,6.6,14,10,4,71,3.2,50339,70,http://content7.flixster.com/movie/10/84/96/10849637_det.jpg,11
25856,Wuthering Heights,32145,Cumbres borrascosas,"http://ia.media-imdb.com/images/M/MV5BMTYyNDY3ODI1N15BMl5BanBnXkFtZTcwNjg3MDcyMQ@@._V1._SY314_CR5,0,214,314_.jpg",1939,1024192-wuthering_heights,7.9,16,16,0,100,0,1,1,0,100,3.9,2525,84,http://content7.flixster.com/movie/31/37/313797_det.jpg,16
3463,Last Resort,258761,Last Resort,"http://ia.media-imdb.com/images/M/MV5BMTg3MjkzOTM3OF5BMl5BanBnXkFtZTcwMzc3OTYxMQ@@._V1._SX214_CR0,0,214,314_.jpg",2000,1105075-last_resort,7.3,70,66,4,94,7.5,23,23,0,100,3.7,459,77,http://content6.flixster.com/movie/28/21/86/2821864_det.jpg,17
63458,Critters 4,101628,Critters 4,"http://ia.media-imdb.com/images/M/MV5BMTkxODUzNDIwNV5BMl5BanBnXkFtZTcwMDI4NzMyMQ@@._V1._SY314_CR0,0,214,314_.jpg",1992,critters_4,0,2,0,2,0,0,0,0,0,0,0,0,0,http://content7.flixster.com/movie/26/51/265125_det.jpg,0
2772,Detroit Rock City,165710,Cero en conducta,"http://ia.media-imdb.com/images/M/MV5BMTI0OTg5NzAwNl5BMl5BanBnXkFtZTcwMTAyMjAwMQ@@._V1._SX214_CR0,0,214,314_.jpg",1999,detroit_rock_city,5.4,36,17,19,47,4.6,5,1,4,20,3.5,9815,80,http://content9.flixster.com/movie/11/15/17/11151771_det.jpg,-33
1648,The House of Yes,119324,Almas gemelas,"http://ia.media-imdb.com/images/M/MV5BMTIxMjc4OTA0OF5BMl5BanBnXkFtZTcwNDkzOTYxMQ@@._V1._SY314_CR2,0,214,314_.jpg",1997,house_of_yes,5.9,35,22,13,62,6.3,8,5,3,62,3.7,1730,78,http://content9.flixster.com/movie/27/35/273507_det.jpg,-16
199,Les parapluies de Cherbourg,58450,Los paraguas de Cherburgo,"http://ia.media-imdb.com/images/M/MV5BMTMyMTQyMTM2OV5BMl5BanBnXkFtZTcwOTMwMjUyMQ@@._V1._SY314_CR4,0,214,314_.jpg",1964,umbrellas_of_cherbourg,8.6,45,44,1,97,7.9,10,9,1,90,4.1,3199,86,http://content9.flixster.com/movie/30/89/308923_det.jpg,11
6967,Dead of Night,37635,Al morir la noche,"http://ia.media-imdb.com/images/M/MV5BMTk5ODkzODg4NV5BMl5BanBnXkFtZTcwMjU2NzkzMQ@@._V1._SY314_CR1,0,214,314_.jpg",1945,dead-of-night-mirror-of-death,0,0,0,0,0,0,0,0,0,0,0,0,0,http://content7.flixster.com/movie/10/91/62/10916205_det.jpg,0
5903,Equilibrium,238380,Equilibrium,"http://ia.media-imdb.com/images/M/MV5BOTEyMjkwODM4Ml5BMl5BanBnXkFtZTYwMTgyNjk5._V1._SY314_CR3,0,214,314_.jpg",2002,equilibrium,4.8,82,30,52,36,4.5,23,7,16,30,3.7,77822,82,http://content8.flixster.com/movie/26/70/267094_det.jpg,-46
56719,Vitus,478829,Vitus,"http://ia.media-imdb.com/images/M/MV5BMTQwOTk0MjA2NF5BMl5BanBnXkFtZTcwNjUwODY0MQ@@._V1._SX214_CR0,0,214,314_.jpg",2006,1174085-vitus,6.6,59,38,21,64,6.3,19,10,9,52,3.8,10168,77,http://content9.flixster.com/movie/87/30/46/8730467_det.jpg,-13
26225,Le genou de Claire,65772,La rodilla de Claire,"http://ia.media-imdb.com/images/M/MV5BMTY4NjI4NDg1Nl5BMl5BanBnXkFtZTcwMTA0NTgxMQ@@._V1._SY314_CR3,0,214,314_.jpg",1970,claires_knee,8.4,19,18,1,94,0,3,3,0,100,3.9,808,82,http://content8.flixster.com/movie/10/88/70/10887066_det.jpg,12
2291,Edward Scissorhands,99487,Eduardo Manostijeras,"http://ia.media-imdb.com/images/M/MV5BMTgxMDQzNzY5M15BMl5BanBnXkFtZTYwNjY2NTM5._V1._SY314_CR3,0,214,314_.jpg",1990,edward_scissorhands,7.6,53,48,5,90,6.8,9,7,2,77,3.8,145994,88,http://content9.flixster.com/movie/10/92/33/10923351_det.jpg,2
4461,Siegfried & Roy: The Magic Box,182299,Siegfried & Roy: The Magic Box,"http://ia.media-imdb.com/images/M/MV5BMTI5NjcwODkwMl5BMl5BanBnXkFtZTYwMDAwMzg5._V1._SX214_CR0,0,214,314_.jpg",1999,1136658-siegfried_and_roy_the_magic_box,6.5,14,10,4,71,0,4,3,1,75,3.2,48,40,http://content8.flixster.com/movie/10/87/29/10872978_det.jpg,31
6716,Daisy Miller,71385,Una señorita rebelde,"http://ia.media-imdb.com/images/M/MV5BOTQ1ODA5MDI4Nl5BMl5BanBnXkFtZTcwMjEyMTAwMQ@@._V1._SY314_CR2,0,214,314_.jpg",1974,daisy_miller,6,5,4,1,80,0,0,0,0,0,0,0,0,http://content9.flixster.com/movie/10/85/64/10856411_det.jpg,80
43011,The Dunwich Horror,65669,Terror en Dunwich,"http://ia.media-imdb.com/images/M/MV5BMTIxMjEyMjk2NV5BMl5BanBnXkFtZTcwMDM5MDgxMQ@@._V1._SX214_CR0,0,214,314_.jpg",1970,dunwich_horror,4.4,5,1,4,20,0,0,0,0,0,0,0,0,http://content8.flixster.com/movie/11/15/05/11150574_det.jpg,20
7011,The Matador,1186238,The Matador,http://ia.media-imdb.com/images/M/MV5BNDQzNjIyNTY3NF5BMl5BanBnXkFtZTcwMTAwMDk5MQ@@._V1._SX134_SY193_.jpg,2008,10009680-matador,6.7,14,11,3,78,6.7,5,4,1,80,3.4,113,56,http://content8.flixster.com/movie/10/86/12/10861230_det.jpg,22
4010,Brewster's Millions,88850,El gran despilfarro,"http://ia.media-imdb.com/images/M/MV5BMjAwODEyOTczOF5BMl5BanBnXkFtZTcwMDIzODEyMQ@@._V1._SX214_CR0,0,214,314_.jpg",1985,1003075-brewsters_millions,4.7,20,8,12,40,0,0,0,0,0,0,0,0,http://content7.flixster.com/movie/10/88/50/10885073_det.jpg,40
2898,The Dark Half,106664,La mitad oscura,"http://ia.media-imdb.com/images/M/MV5BMTA3MjgzNTM2NTFeQTJeQWpwZ15BbWU3MDY2NDE0MjE@._V1._SY299_CR1,0,214,299_.jpg",1993,dark_half,5.8,17,10,7,58,0,3,0,3,0,3,2007,43,http://content9.flixster.com/movie/27/95/279515_det.jpg,15
7811,Babylon 5: The River of Souls,146247,Babylon 5: The River of Souls,"http://ia.media-imdb.com/images/M/MV5BMTcxMTYwNTAzM15BMl5BanBnXkFtZTcwMjc0ODAyMQ@@._V1._SX214_CR0,0,214,314_.jpg",1998,babylon-5-the-river-of-souls,0,0,0,0,0,0,0,0,0,0,0,0,0,http://content8.flixster.com/movie/10/89/29/10892922_det.jpg,0
2544,L'école de la chair,157208,La escuela de la carne,http://ia.media-imdb.com/images/M/MV5BMjE4MDMzMDI4OF5BMl5BanBnXkFtZTYwMzk3Mzk5._V1._SX144_SY210_.jpg,1998,school_of_flesh,6.1,18,13,5,72,0,4,4,0,100,3.5,272,59,http://content9.flixster.com/movie/28/37/283715_det.jpg,13
7791,Internal Affairs,99850,Asuntos sucios,"http://ia.media-imdb.com/images/M/MV5BMjEzMDUwNTg2Nl5BMl5BanBnXkFtZTcwMTI0NDYyMQ@@._V1._SX214_CR0,0,214,314_.jpg",1990,internal_affairs,6.7,25,22,3,88,6.9,7,6,1,85,3.2,1646,56,http://content9.flixster.com/movie/27/30/273007_det.jpg,32
6073,La decima vittima,59095,La víctima número diez,"http://ia.media-imdb.com/images/M/MV5BMTUxODcxNzUzOV5BMl5BanBnXkFtZTcwNjMzNDgxMQ@@._V1._SY314_CR3,0,214,314_.jpg",1965,tenth_victim,0,4,4,0,100,0,0,0,0,0,0,0,0,http://content8.flixster.com/movie/10/89/40/10894082_det.jpg,100
55498,Silk,494834,Silk,"http://ia.media-imdb.com/images/M/MV5BMTMxOTk4MTMxMF5BMl5BanBnXkFtZTcwODc4NjE1MQ@@._V1._SX214_CR0,0,214,314_.jpg",2007,1174809-silk,3.8,55,4,51,7,4.2,17,2,15,11,2.8,5170,33,http://content9.flixster.com/movie/10/87/11/10871143_det.jpg,-26
27491,Kairo,286751,Kairo,"http://ia.media-imdb.com/images/M/MV5BMTY0NjgwNDU2MV5BMl5BanBnXkFtZTcwOTc1MjIzMQ@@._V1._SY314_CR4,0,214,314_.jpg",2001,1113170-pulse,6.8,48,35,13,72,6.4,14,10,4,71,3.3,3346,61,http://content8.flixster.com/movie/25/05/250502_det.jpg,11
5711,Die bleierne Zeit,82081,Las hermanas alemanas,"http://ia.media-imdb.com/images/M/MV5BMTI5MjY1MTA1NV5BMl5BanBnXkFtZTcwOTM4ODMyMQ@@._V1._SX214_CR0,0,214,314_.jpg",1981,marianne_and_juliane,0,1,1,0,100,0,0,0,0,0,0,0,0,http://content8.flixster.com/movie/98/97/03/9897038_det.jpg,100
1218,Dip huet seung hung,97202,Dip huet seung hung,http://ia.media-imdb.com/images/M/MV5BMTIzNjAyOTU3Nl5BMl5BanBnXkFtZTcwNTUwNjQyMQ@@._V1._SX98_SY140_.jpg,1989,1032434-killer,8.6,31,31,0,100,0,4,4,0,100,4,6079,91,http://content6.flixster.com/movie/29/00/290000_det.jpg,9
6513,Made for Each Other,31602,El Lazo sagrado,"http://ia.media-imdb.com/images/M/MV5BMTIwOTkwMDUyMF5BMl5BanBnXkFtZTcwODkyMzU1MQ@@._V1._SY314_CR50,0,214,314_.jpg",1939,made_for_each_other,0,2,2,0,100,0,0,0,0,0,0,0,0,http://content7.flixster.com/movie/47/49/65/4749657_det.jpg,100
3696,Night of the Creeps,91630,El terror llama a su puerta,"http://ia.media-imdb.com/images/M/MV5BMTIyNzg1ODY1Ml5BMl5BanBnXkFtZTYwMDM3Mjg5._V1._SY306_CR1,0,214,306_.jpg",1986,night_of_the_creeps,6.7,11,8,3,72,0,0,0,0,0,0,0,0,http://content7.flixster.com/movie/20/77/76/2077765_det.jpg,72
27828,De zaak Alzheimer,374345,La memoria del asesino,"http://ia.media-imdb.com/images/M/MV5BNTEyODk0MjYwMl5BMl5BanBnXkFtZTcwNzUxMTEzMQ@@._V1._SX214_CR0,0,214,314_.jpg",2003,memory_of_a_killer,6.8,67,56,11,83,6.9,22,19,3,86,3.7,1053,77,http://content9.flixster.com/movie/25/00/250091_det.jpg,6
52668,In the Land of Women,419843,In the Land of Women,"http://ia.media-imdb.com/images/M/MV5BMTQ4MDQ3NTExMV5BMl5BanBnXkFtZTcwMTA0OTM0MQ@@._V1._SX214_CR0,0,214,314_.jpg",2007,in_the_land_of_women,5.4,114,50,64,43,5.2,33,15,18,45,3.2,37584,54,http://content6.flixster.com/movie/54/85/19/5485192_det.jpg,-11
58084,Street Thief,872224,Street Thief,"http://ia.media-imdb.com/images/M/MV5BMTc2ODk2ODU1MV5BMl5BanBnXkFtZTcwMTY5NTI1MQ@@._V1._SX214_CR0,0,214,314_.jpg",2006,street-thief,0,0,0,0,0,0,0,0,0,0,0,0,0,http://content8.flixster.com/movie/10/89/05/10890526_det.jpg,0
5457,Zebrahead,105885,Zebrahead,"http://ia.media-imdb.com/images/M/MV5BMTcxMjc5NDcwN15BMl5BanBnXkFtZTcwODY4NzcxMQ@@._V1._SY314_CR1,0,214,314_.jpg",1992,zebrahead,6.1,14,10,4,71,0,4,3,1,75,3.3,221,62,http://content6.flixster.com/movie/28/33/283392_det.jpg,9
2297,What Dreams May Come,120889,Más allá de los sueños,"http://ia.media-imdb.com/images/M/MV5BMTQ1MzA4MTIzOF5BMl5BanBnXkFtZTcwMDMxOTcyMQ@@._V1._SY314_CR1,0,214,314_.jpg",1998,what_dreams_may_come,5.7,66,36,30,54,5.8,16,9,7,56,3.6,31618,85,http://content6.flixster.com/movie/26/24/262404_det.jpg,-31
6877,Girls Will Be Girls,339071,Girls Will Be Girls,"http://ia.media-imdb.com/images/M/MV5BMTY0OTUzNjQwOV5BMl5BanBnXkFtZTcwMjk3MTUyMQ@@._V1._SX214_CR0,0,214,314_.jpg",2003,girls_will_be_girls,5.6,31,18,13,58,5,13,6,7,46,3.6,1305,71,http://content9.flixster.com/movie/10/88/47/10884783_det.jpg,-13
1395,Tin Men,94155,Dos estafadores y una mujer,"http://ia.media-imdb.com/images/M/MV5BMTg2OTU1MzI1NF5BMl5BanBnXkFtZTcwODgyMzcyMQ@@._V1._SX214_CR0,0,214,314_.jpg",1987,tin_men,6.4,19,15,4,78,0,1,1,0,100,3.1,778,54,http://content7.flixster.com/movie/26/96/269609_det.jpg,24
2430,Mighty Joe Young,120751,Mi gran amigo Joe,"http://ia.media-imdb.com/images/M/MV5BMTI1MTM5MDk1Ml5BMl5BanBnXkFtZTcwMjI3MDIyMQ@@._V1._SX214_CR0,0,214,314_.jpg",1998,1084582-mighty_joe_young,5.8,42,22,20,52,7.2,5,4,1,80,2.8,10755,48,http://content6.flixster.com/movie/59/50/68/5950684_det.jpg,4
51911,The Fugitive Kind,52832,Piel de serpiente,"http://ia.media-imdb.com/images/M/MV5BMTgzODg3MzkxM15BMl5BanBnXkFtZTcwOTg2MjU1MQ@@._V1._SY314_CR73,0,214,314_.jpg",1960,fugitive_kind,6.4,10,6,4,60,0,0,0,0,0,0,0,0,http://content8.flixster.com/movie/10/43/31/10433130_det.jpg,60
3882,Bring It On,204946,A por todas,"http://ia.media-imdb.com/images/M/MV5BMTIxMTg3ODA1NF5BMl5BanBnXkFtZTcwMTkzMDEyMQ@@._V1._SY314_CR1,0,214,314_.jpg",2000,bring_it_on,6,115,73,42,63,5.7,32,19,13,59,3.1,100795,68,http://content7.flixster.com/movie/10/89/97/10899785_det.jpg,-5
6145,Venom,428251,Venom,"http://ia.media-imdb.com/images/M/MV5BNjA3NTk5NjI0MF5BMl5BanBnXkFtZTcwOTMwMTIzMQ@@._V1._SY314_CR3,0,214,314_.jpg",2005,1151780-venom,3.1,62,6,56,9,3.5,19,3,16,15,2.6,2557,30,http://content8.flixster.com/movie/25/01/250118_det.jpg,-21
5120,Sleuth,857265,La huella,"http://ia.media-imdb.com/images/M/MV5BMTM4Nzc0MTA5MF5BMl5BanBnXkFtZTcwNDI1MjI1MQ@@._V1._SX214_CR0,0,214,314_.jpg",2007,sleuth,5.1,118,42,76,35,5.1,30,10,20,33,3.2,9724,53,http://content8.flixster.com/movie/99/66/35/9966350_det.jpg,-18
